(19,137)
(58,8)
(30,63)
(78,151)
(45,83)
(110,148)
(82,20)
(76,91)
(25,5)
(55,105)
11011011111111111011101011110111101101010111111111111101111a1111011001111111111101001111111111111110111110111111010101101110111111011111110111111100011110011101
01111111111011101110011111101111111111110111111111111111110a1011100011111101111111111100001111101111110111011111111111111111111011110011111111111011111101101101
10011110111111111111101110100111011111011101010111011111111a0101111111111111111111111111101111111111011111101011111111111111011111110111110111111111111111111110
11110111111101111111111111110010111110111110011011110111110a1110010111011111111111111111011111011111011111111111101111111111101010111101111111111111011111101001
11111111101111011010111111101111111101011110111111101111111a1011011111011111101100110011011111111110110011111111011110111111111111111111111011000011111111110011
01100111111111111111001111111111101011111111111110111111111a1011110010111111010101111111111011111011111110111101111011111011000011111101111011000111111111111011
11111111111111111111111010101110111111111011111110111101011a0011110111111111111101011111111110101111111111011110111111111111111011100101111110110111011111111100
10111111001111111111111111111111101101101111111111111111110a0111010111111011111100111000010101111011111001011111111100001101111101101111010011110110111011110011
11100111111011101111111111111111111011111111111110111101110a1111111111111111111110111111111111101111001111011111011110111010111111101101111110111111011101111101
11101110011111111111101000110100100111111011111111111011001a1101100001101111110011100111111110011111111111011111101111111101111110111111111111011101111111101101
22110221011121122121111111111111100111111111111111011110101a1101101111110111111111001111011111010111111111111111111111001001111111111011111111100111111100111111
21011010221112222201101010111101111111011111011101101111111a1111011111111111111011111111110110001111111111111111111010110101101110101110111111101111101011001111
12222212110111110102110111001111111111101111111111111001000a1111111111111011111101011111011111111011110100111110111111111111111101111101111101111101111100111111
11221012121211222012111011110001111010111011111110111010111a1111111111111100110111111111101111101101111011111011011011111111111011011111111101111101010011011111
00212202122222120221111111111110101111011111011111011110001a1101110111011011011011111111101111110100011111101111111011101111111111101111111111111111011111011010
21221102111110220221111101100101111111110111011121220210122b1122120221221221121101111111111111111111110111101110111101101111111010110111111000110111110111111011
21012002110121201100111111111111111111111111111100100211220a1122212220112122121011011011101010111111111011111011111111001111111001111111111111111111011111110111
12222101121022121211100111111111111111101111111102122110211b2211102022102100200111111000110110111111aaaaaaaaaaaaaaaaaaaaaaaaaaaaaaaaaaaaaaaaaaaaaaaaaaaaaaaaaaaa
aaabbbabbabaaaabaabaaaaaaaaaaaaaaaaaaaaa1001011110221112101a1121010021121002201111111100111110011100a11111011110110111111101111100011111111111111110111111011111
222221122112211101211111111111101101111a0111111111212221111a2212211210220211111111111100111011101110a11011111111101001110000110101110111111110111101110100111111
212211100122112221211011110101111101001a1101111111221220102b0122012122221211121110111011111111111110a11101111111111011111110111011010110011101011111111111010111
221012111202201210010001110101111111111a1111111120211121121a2021120212021210221111001111001110110010a10011101011111001110111111001001110111101011111111111011111
112211210122201010101011111111111110111a1110110111102202111a1020210112010202221011111111111111101101a01011111010111111110111101111111010110011101111111101001111
110101122102221111201111111111001111101a1111010111221221002a0120212221111012121111111011111111111101a11101010111111011111110100111001100111111111111110101111111
002022022112201122221111111111101101111a0101111110021120012a0112002201121101001101110110110110111101a11111101110111101011100111110111111110110001111011111111101
222121212212211221011111111101111111111a1111011122011021021b2212222212021112210111111011110111111111a11111101111111111111100100111101110111110111111111111111111
121111110211210222121111111011101111111a1101111111201220112b1212202221111221111111110111111111011110a11011000101101101111101110011111110011111011111101111100111
012101102211121110121110110101111111011a1011011120220211202b2120220102101022111110110111111111011100a01110010111111111111111111111111011111111111101111110111110
112202111000102110201111111101110100111a1111111121202121022a1211220022111022021111111111111110111001a10111101111001111111101111100011111011101111111011111100111
120210210002212010111111111100111101111a1110111001202100221a1121122122111212211111111110001111111110a11111111111111111111111101101111011111101111100111011111111
021222202112112111211111111101101011111a1111100122220011222b1111120121021122222210202221212222000111a11111111101111111101101111100110110111111111101111101111111
220212122102000211021011111101111111111a1111111112221210201a1111020201012212222211221111210211200211a10101111111111111111111111111110100110110111111011111111011
122210021120220220111111111110111110111a1111010112201021102a1202111122222212211221211221211212021111a10111011001100111011110101010101111101111101111111111110111
021112102200221220001011100111111111111a1111011022210211102b1222011122222212022222122200211121010101a11111110100111111011110011111111111111111011110101100111001
102202112211110022110111111111110111111a0010011122221220121a2112010122212221212102122121101121002211a10101111111101111111111111110101110011111001111001011101110
221222200121222122100101101111100101111a1111111122202202100b2221100102202010220211221101211001012111a11101110100111111001011111111100110111111101111111011111001
011121110112202212021110011100100011101a1111111112112211210b1222011200112022121122102020220111011210a10011111111111111111111101111111111111111011111110110111111
111112221212111122221111111101111111111a1111110101202001011b2221002122210221222120122222122212021211a11111101111010011110110100111111010100111010110011110001011
111221211212201122111110111011001110101aaaaaaaaabbaabbbaaaaa2111122122000222102202201122111111121210a11111111101111111111011110110111111111101111111111110111011
2101001212221202210111111011111111111111111011012222211121111212222222222222122200212220120112222101a01011111111111101001010111111110111111110111011011010111011
0101111111111111011111111111111111111001111101112111220212220020221222122212221112021211200020200212a01112210202222112221010111011111111001101010111011111111111
1111111111010111111101011011111011011101110111011002201021111211222100220122221121221121220022212222b12222122221102012211111110110011010110011110111111111111101
1011011111110110111111111101011111010111111111110222012021011221121022012222122102001212121022022220b21212222122112102121111111011101111110110111111111111111110
1111001111111001110111110111111111111111011111111112111202211100211202022220202110201111222022012211b22221200220121210211111010111010110011011101110111111111111
1111101011111111111111010111111111111011011111111111002201122220101122222222020221122101122122022200a21121110110222020111111011101111110101111111011011011111011
1111101101101110111111111111111101110111111111111010111110110011111122002102212112112001102222222211b11101211022201222221111111110111110111110111111111111011110
1111111111111110011010011111101110011111010111011101110110111111111112112011111202122222222212212202b21222022121102122121111111011111110111011110111111110011110
0101110111101001111101111111111111110111111111111111110100111111101102122110022110201110221012222211b11212002212002111221101111111111111111101111111001111101111
1110011101110100010101111110111000101110110011111111101111111111111121100022221200121122222221122102b22100020210021221120101011011111111111111111111111111101110
1111110111111110111110110110111111111101111111100101111111011111111122102221111221212222112222221221a11221101211122220001011111110101111011111100101111101011111
1101011001111111110111011111111110111111111101111111100110111111010112222022212100201211222002022221b22122101220210200211011101110110011111111011110101110011111
1111111111001111111101101011101011000111111111111100110011110111111102020211021101021222111212220210b21122021101012222200111111110101111110111111110011110001011
0111111110111111111111011111111011110111011111101010011111111111101021110220102221011102222211202210b21112122101002020111101111011111011111101101011111111110111
1111110101011101011111111111011110011111101101111111111111111011101120221212101111112211211202020111a21212122210012110211110101111111111011101111111011111101101
0101011111100111101111011011110111111111110011110110111010111111111022122120122111122102211221212222b20221120211010120221111111111011111011011101101111011111110
1111101101111111111110011111110111111110101110100111011111111110111111222221221122212010102220212221a01011212222222222121101100111111101100111110111111111111111
1110111111011011100110111111011100111111111111101110110111101001011021021122212202112100221022122021b21111112221102221111111111111111011011011110111111111110111
aaaaaaaaaaaaaaaaaaaaaaaaaaaaaaaaaaaaaaaaaaaaaaaaaaaaaaaaaaaaaaaaaaaaaabbababababaabaaaaaabababbbbbbba12212111201222222210111010010111111111001011111101001111111
a111111111111111110100111101011111111001011111111001111110111010110112121112112222110021000221022222202120012121122001121011101110111001011110111111110111111111
1011111110111111111111111110110111111111111100111011011001111111111121102221211221111101100222212210211211112011011211211110111001111011011011111111111111111111
0101111101111110111101111111011100011111111111101110111111111111001111110111111101111111112121212222102112112120222211121111100101101111111111100111101111111111
aaaaaaaaaaaaaaaaaaaaaaaaaaaaaaaaaaaaaaaaaaaaaaaaaaaaaaaaaaaaaaaaaaaaaaaaaaaabbabababaabaababbbababbababbbbaabababbaaabbbaaaaaaaaaaaaaaaaaaaa11111111111111111111
0011110111111111010111110111111101111110101011111111111101111111111111101110220121211020112200222201022202121122222122211000111111110011111a11111111111111110011
1111111010111110111111011011111111010111011010001111111010111101111110111101021200111221222220220221222220112001221212021010101111111001010b11002121222211200022
1111110111011111111110111011011111111101111011101111111111111111111101101111021010121120111122222221222022221200022110011111110111111111221b11121221221122212211
1111111011111111110111111111111010101110111111111111011111101111110111111111121121211211222222220022222212011221022202120111101111111111201b22222211110121212102
1110111111111110111101011111110111011110110111011111111111111000101111111111022210212111101201220112222212111120222010220111011111101011122a12121121220112111212
1011020022220121010120120222221220011110011101011100111111111111011111110011122222102101202222201221021212110110202010011101101110110011221b12200011121122120122
1111111112111201120102102211222022010111100001110000111001111111011010111111001022121011210122001202210122102211112011211110101010101101211b20121220012211121201
1010002012222202001122101101101000011011011001101100110011111111111111110111221102011202222020212122221122111210001000210101011111111101122b22022021120221011202
1011021211211122222220022112022211201110010111111111001111111101010100110111112200222121020022211102221112101111111101111011111101111110211b12211211221222121021
1011012111112212012221212122121212110010111110111110111111011001011111111110121021201212121212121120112200111000011101111111101011111111022a11210212121222012121
1111101222121222220022120021222101110011111111111110111100101011110111011111012100201221011022122122022002100011111101011111111111101110220b11022222112221211122
1111112121111212122222200121012101110111011111011111111111111111011111111111222222202011221021011221221012110111111011100111111111111011222b11021101220111210220
0111102202011222012211200120222111211111011111111111110110111101111011011011111212212211111122212010110201001011111011011111111111010110221b01011001011211102001
0111011020221110221210102110212001011111110111101111110111101111001111111111212202111012122201021102222211111101111111111111111111010101222a12102011102121221212
1111001100222111122022112221022122110011111111110101011001011110011111111111210112122010011222102222202102011011001101110110011011111111011a22222021102121000211
0101112222210210122211211221111220210111111101110110111110011111111111101111212212110102211211122122101102111111111111111111101111111101210b20010221110010221201
1111111212112012022220022122112210111111111111101111101101111001101011110111020101201121212122022101222221111101111011011111110011111011221a12122121112112012212
1111122111212022202212202022222111011111011111111111010011111111110100101111211221112122210002221102212020111110111111111010111111111100002a11011110111212122121
aaaaababbabaaaaabbabbbbbaaaabbabbaaaaaaaaaaaaaaaaaaaaaaaaaaaaaaaaaaaaaaaaaaaaaaaabaaaaaababaabaaabbabb1112111111111111111111101110111111111a10201012221021122222
11111102122221122101011011100120102111111111101110001111011111110110111111102202212221112001221212100b2220111111111110111111110111101010222bbabaabababaabbaabaab
11110022110122211120201210201222121111111010111111101101111011111111111111110020121022121212222201212a110111101111110111101100111111111121001112122120021121201a
11110221011202202122022011111222221011111111111111110111010110111111111111111110121021112112022212011a2201101111111111101111110111111111222221210212112100021021
00111022102210211012222000111122221111110111011111111111111010110111111111012110121222012211211110110b1011111101111110011011111111110111212020020022111021212221
10001111200022122101111211122121222111101011101101111111111111111001110110111012112022121201220101210b0111111111111101110111011111011111220120220112121122222121
11011211021222221222122122221121121001111011101101100111111111011111111011100012021121101012211121221a2112111001011111111111101011110111011122112010202111022111
11111121210202220210121112201221202111111010101111111111111111011110101111112112112021202012002221211a1100111111111111111111111101101101210212221122112221212201
11111121212122122121201201222222110100111100111111110001111111100100101111111220111012121120122112211a1212111111111111101101111100111111100012122012102221021122
11111220112211012012010021111212021111010111011011111111111111101111010111012201222011211102122121222b0212101111111111111111101101111111212202101111220011021002
11101121212022021100212222201122122111010111111111111111010101101111111011112220122001022202102021012a2222111001111111110111110111101111022221120111221221221021
11011022001022212121110102201100012111101111111111111011110111111111010111011111011110110111101101110a1111111111100111101111111111111111211122222111012211120221
11111220021200022202021211122221222010110111111111100011111111011111111101101111011111011111011111111a0100110111111011111011011111111111112221210011221121212221
01111101011112221211111212111111111110110010111111111111111111111111111111010111111101010111110100101a1001111111110101011011011111101111111111101101111101110111
11111211112111111110212201210202122011011000011011101011111111111011111111110011011111011101111111010a1110111101111111111111100111111111111110101011101011111111
11110100221022222211122112120222000111111010111111011010100111101101111111011010111111111110001111111a1101111111110110101111111101101221102011012221211021220202
11111022121111120121201122102022111110111111111110011111100001101111110110011101111101110111011011110a1111101111101100101111111111111222102002220221020121202121
11101101111011111111111111110111101111111111000001111011101111101111111111110111111011110110111111011a0011111111111011110111111110111022122212021221102102100221
11101110111111011110111111111110111000111011111111111011111110111111111111110111101111111111011111111a0111111110111011111111111011011010122211222012122201221211
11111111110010111101111001011111111111111010111111011101111101100101110111111101111111111011111110111a1111111110111111111101111111111122211121022121012111210112
111110111110001111100111111101111111111111111111011100111111111111001111010011011aaaaaaaaaaaaaaaaaaaaa1111101011011111110110011101010121221110110012012110122122
111111111111111001101011111111110100011111101111100101110101111111111111111111111a110111111000011011110110111101110110111111111011111002121012111110112122102111
111101101111110101111111111111100011001111010111111110111111111011100011011111010a111111111110111111111101110011111111111111111101101221221021122022120122111221
001110111110111110110111101100111111101101111110111111111011110001101110111110100a011111100111111011111111111101111111111110101011111111022011222101211001012110
101111111111011111111111111111111111111111011111011111111101111111111101011110111a111111100110001111011111011100011110110101101001111212212201111111201111001010
111111101111101101101110110111011111111111111110111111000110111110111111100111101a110111111111100111011111110111101111111111111111111212222021110001211112220222
111111111111011111110111111111101010111111111111110111001111011111111110111111110a111101111111011010011100111111111111111111111011101222122110220022121211011202
110111100011111111111111111001111111111111011110100111111111101111111101011111101a011111101101111011101111111011110111111011011101111121022121220211000112120112
110111110011111111011111101111011111111101111110111100111111011110111001111111011a101101111111101111111111011001111011011011010111111220112101210022122212012011
011111010111111101111110111111111111011110101111011111110111111101111011111001101a011111111111111111111111111111111111111011101111111211221222210221210211022111
111101111010001000111111011001111101011111111111110111111111111001111011111101111a101100110111111111111101011110111111011111101100111221221210212211222121212012
111011111100110111111101111111011101011111101111101111110011001111111011110111010a110011011111110111111111111111010111111011111110011011212220101222210101200012
011111111011101101111110111011111111111111111110111101101111000110110011011101110a100110111011110110111111111111010011101111110101101112200220202012221222111202
010111101110110101101111110111011110101111111100111111111011111111011111010111110a011111111100111111010101111111111111001101111111101222222111122212212000021201
110111111010111111101011110111101010111111111110011111111111110010101111110010111a110111111111111111111011111111111110111011110001101211122212222210102002111122
111111110111101111101101111111100101101111111111111110111111111111100111111111101a100111111111111111111010110111110111111111101011111211212102121211021221101101
111101110011111111111101111111111101111101101111111111101110011110111011010110110a111111111111011111101111011001111111101111001101101212022021211022220011211021
111111110111111111011111111011111111110111011111111100111011101110011101111111011a110111011111111111111111011011111111111011111011111111102111200011222100022112
111111011000001111111011011101011101100111110111111011111101011111111111110110110a101111111111111011111011011111111111011101111100111021022110000112022112200211
101010111111011010111111111011110111111011111111111011011110011100101111111111111a111111010110111011111111111111111110001110101110111010122010221222212012211002
