(106,128)
(5,151)
(34,2)
(48,103)
(118,102)
(49,24)
(88,87)
(23,32)
(14,26)
(18,53)
0111001111011212202b222220022211221100221110111011001111011111111110111011111101100011110111111110111111110111111a0011111111111111111111110110111111111111011111
1111101100102212111b212211220111122001011111111111101111011101111111110111110111111111111101111111111111101010101a1111111111110101111101111101101010111110111111
1011111111110202011a002122112222102122021011111111110111111111001111011110101111111111110111111111111011111111111a1111100111110101111101111111011111101111111101
1010111110011222210babbbabbaabaaaababbbb1222111200121220121011111000011011101110111011101111100001111110111111100a1111111110111011111111111001111110111101010111
111111110111121121012211011201002112022a2022122110110122102112212012111110111111011110111111011011111110011111111a011111aaaaaaaaaaaaaaaaaaaaaaaaaaaaaaaaaaaaaaaa
111110110112120022200202101222111222212b2121202020121221112210022112101111111111001111111111111111011011001101111a101111a010111111111111111101111111111111011011
110011001102222122221120100200122120012b2120220111222001202201011011101110111011111101101110101111111110111111111a111111a100110111101111111111111111111111111101
111110011001022221221011021012112200212b2221112211102100020122002210110111111110111101111110111011111110101111110a100011a100111111111010011111111111111110100101
111111101110100100220222122221222210102b2102222122222122011212212021010110110111111111011111110111111110111111100a111111a111011011110111101110111111110111101111
101101110012212222202022000222200121202b0222222011102212111222121212111000111111111111111010111100111011111110110a110111a111111111111101111111110100110111111110
011111011111221112102222121022120220222b0220121112021222010122222211111011011011110111101111110111111111111111111a111101a110111111111101111001111111101111111111
111110110012210022011211222201102220022b2011221120112120222120221220111011101111110010111111111100011111110101111a001111a111011011110111111111101111101111111011
111111111110111122112221220122221211012b1202212220210122121021212110111111101111111101111111110011101111101111101a010101a001110010101110111111110111111110111111
111111101111122012221221202112222212212b2222100212111200221221222011111101111111111111101010111111111111111011111a111111a110111111011110111011110111111001111101
100111011111212112002202101220022220002b2100202122020112110212111202101111101101111111011111110111100111111101011a110010a111111111111111111011110111111111111111
111111111100122102200012012202212221222b0222212221012201201221021102110011110111111111111111011010110111110111111a111111a111110111111001101111111111111111111110
111110111112111020220221222022102222202b2222022021011222112211121212110111111111101111101110101100111110111010110a101101a101111011111111111111111101111111011101
111111111111212002211212122222101202222b2200022112222111121201111220111100110011101001111111111111111101111111011a011111a111111101111111011001111110111101111010
111011111101212211111122122022021121100a2222022112002020022110111010111111011101001111101111111001111111111101101a111111a101111111111111110111011011011011111011
210122212111212022222122102002120122022b2220221212121101221000112112111011011010001101110111101111010101111111110a111110a011110011111111111111111011101101110101
201222122111200212112002122222221120202b2210201122212212211210021021110111101111111101101011101110111111111111111a011110a011110111111010111011011110101011111100
121101222211010222021022220221202122020b1222210012101022200122112101111111011111111110011111111101111111111111101a111110a110111111101111111111101111100010111011
121021212220220201212222221222220222210a2202222122220112202012220011111111111111111011110111111011111111101111011a111110a100101101111111111110111001101011110110
012111212112202022202202121222122122222bbbbababbbaabaabbbaaa12222121110111111101101011111111010111101011111101101a110111a111110111011011101110111100100011111110
21001111221222222002222122110000222020102102210201022110220a12112122110101110011101111111111110111111111111111111a101110a011101111011110111111111111111111101111
11121120001122122120212122112202021202221110221202121222112a21221011111111111111111111111111101011111011110111011a111110a110111110111111110011111110111111111111
22102112222121212222220022022122022220220112222121111101222b11112202011111111101110111111111111101111101101111111a011111a111010001011001011100100111111111011110
11022211012222011220202022222221120222202212012022112002222a21212212111111011111101110111110111111111001101111110a101111a111101111111111110111111111111111011010
20102111202222212222121222222021222212222221220122212222111a02120201110111111111110110111110111111101111111101011a011111a111111101110101111111111111111010011011
12121121111012201101212011102222212122221122102222012012022b00211121111111111111011111110111111111111111111100110a101110a111111111111110011011100101100110011111
20111100100112121100102112110221122121222222011211102121221a21220221101101111011110101111111111011111111110111001a101111a011011011111111011111111111111010110111
20201012221011020120101212120210221111122122122120210120002b11112212010111111111010100111111111101110101111001101a101011a011111111110111111011101111110011111011
02121112111101121102110012111222121112211010001220212002222b11110211110111101111111011111111011100101111111111010a111111a111111000111111111101110111110110011101
22021112202221222122010222222202002222211021121111111111111a11111110111111110111101111112211202121112112002222210b120101a111101111111111111111111101110111111101
02112112102222222021200221111222220221111212211111111110011a10110100001111101101111111110022212120221121122220222b202210a111111011101110110111111111011101111111
12221112002222222121122222222220022121101210211111101111010a11111111100110110101111011111012111012202102221122012a221111a001111111001111110011111111011111011011
21000101002020020222221021211022100221201210222000101111010a11100111111111111111101011102111211112210122011211222a220201a111101111101011111101111110111101111111
22122211122022222200021001201222222022100112111001111001111a01101111011011011111010111112110021112201112100222221a210010a111111011111111011011011110111110111111
11010121001022222201201122121012021021201111001111001110111a11101111111110111111011011011220112222120002222101211a001211a111011111110110111110011011110111100101
22001110220220122021212120220220122221101101111111110111110a11111110111111111000111111112022012210201220020221122b020011a111011111111011110110111111101111111111
21111122120212221012201020112211211011011111111101110011110a11111111111101011101110101112011122201121111111102111b021211a110111100101101100111111110111011111101
22111112120020222222121010011101202021111101111011111111111a11101110101111111110101110111210111221201211221002221a010011a111011111011001011010011011101101111010
20112120202122121111221220122012012111011110111101111101110a11111111011111011000101010111002122021200112021011000b112111a111110111011111111111001011111111111110
abbabababbbbbbbbbbaaabababbabbaabbabaaaaaaaaaaaaaaaaaaaaaaaa01111111001111111111111110110111100012201111011101202a122211a011011111101011111011111110110111101100
02011000021102000111222021211210212021011111111111111101111111010111111011101010101111112110120211120101011021021a211111a111111111110111011111110111110101111111
10000000122022222220122012022111111111111110110011011101101111111101001010110111101111102221212211222121001020121b222211a101110111111111111110111111111111011101
02111221010121222222210212212112110101210111110111101111111101011111111011011111111111102212111211021121201012211b120210a101111101110111111111111011101111111011
21101211121220102122022210121022110102111110111110111111110111111111101101111111111011101200122022221211222200202a010211a111111110011110111111111110101110111111
22202112022222022112220020212211002221011111111100001111110111011111110111111111110111111110221011101121201211121b212211a011101011111011111110011001111101111111
10011111120012120011021110111111220212001111111100111110110011110111111011111101111111111112212211122121212121222b121211a111111101111011111111110111111111101011
10110011110220021020111221122120212100211111111111101111111111111111111110111111111111111122222102112221221101210a111200a111111101101111111110011111111101011111
10001010122111020111212100102202212211011111011011110111111111111111111111101000101101010201110210201201122221202b220101a111111111110110111111010111111001111110
11111110101221211222220112222121211012201111100111101101111111001011111111111111011011112120220122210111001220202a022211a111111101011110011110110111111110110111
10111111111212121221222111212020022111201011111111111010111001111011011110101111111111101212112120211222201121121b102201a111111111111111111011101111010111111111
11110111102202220211201101211012022121201101111111101011001111111101011101111011111101110212212221221011121111111b212110a011011111101111110010110101011110111011
01111111111120120201102222212212222210211111111111110011111111100011101111111111101111112202112001011222010211220b112111a111011100111011111111011111111111110110
11111111120200002102221111111100121112101101111011111111111101110011111111111110111111101100110211212102202121222a112101a111011111111010111111111111111010111111
01000101112121222022211200220212021212111111011110101001011110111111101111110110010111102121212022010021111201101a112111a011111110111101111111110001101110110110
00111101121222202211101211201012022112111111111011101111101111111100111111111101111111112012122220022222022121212b010111a111110111010110111101111110111111101111
11111101112211112001121211120101211122011111101101111111111110011111111011111111111110112201001112010021210112111a122110a111101101111111011110111111111111111101
01111011111212121122222012212220102211101101010101111111111111010111111111111010010101012222210212122222001022221a002211a100101111111111011101101011011110111111
11111101121221121102022220200211102021011111101101111110111111111011111101111111111111111121210121211022202211120b212211a111111111111011111101001111111011001001
10110110101122201012111122212021121222011111011111111111111110111111011111111011101111012001211110101112221011210b102111a111111001101110111110111111111111111111
11111101101222022212122010221002011111210110110111110111011111111111101110111011111111011011111001101011111111110a001111a101110111110101111111110111111011111111
11111111110101111111111011110101010010100001111011111111011101111111101111101111111111111011111111011111111100111a001110aaaaaaaaaaaaaaaaaaaaaaaaaaaaaaaaaaaaaaaa
11111111011101111111111110101101110111111101011101110101111011111111001001101101010110111111111111111111001111111a0111101111111111111110110111100111110011111111
11101111111110101111111101011111111011111101101101111110001101100101101111011110110111111000111111011111111111010a0111111011111111111110011111010111101011111000
11111111111111111111101110111111111110100111111111111111111111111011011111111111111101011101111111100111111111011a1101111111111111110101011111011111101110111111
11110111111111111100111111111111111101111111110111111111011111111111010111111111111111110001110111011011111110111a1111111111111101011101011111110011111111111111
11111111111111101111101101111101111011111111111111011011110110111111010011111001111111110111101111111111111111011a1100111111011111101101111111111101001011011111
11111111111011111111011010111101111111011111011111111111011101011111011111101101111110111111111111101011011111101a1111111111111110101011111000011011111111001101
11011011111111111100111111110111111111111111111111111100111111101111011110011010111111110111111101100000011011111a0111111111111111111101111110111111111111111111
10111101111110111111111011110111110110101101111011111011111111111111110111111101111111111111110111111001111111100a1111111111111011111111111011110011110101111111
01011111111111111011111111111101111111111111101110101111101111101111111102220112112001121111021202221210101111111a1101011111011101010111101111110011110111011111
00110011111011111011100011010111110111110111101111011111111111111111111111120012201021112210112122111111001011111a0011111111110011111011111111101110110011111111
11111111011111011111111101111111111011111111010101111011010110111111110111022120212012021202202112121110011110111a1111111111111111011111111111111100011000101101
11111111010111011111011111111101111111011111111001101111111101111111110110021211210212122212010200102210110111100a1101011110011111111011111111111110111111111110
11011111111110011111111111101111110111111011110111111011101011010101111112222111121111202021221011200211111110110a1110111111111101111110111111111100110011111111
10110011110011010011110101111101110010110110101111110111000111010110111110010220122100211021222112212000101111100a1011111111101111111011011101111111110011111111
11100111111111111011111101111111011101001111111011110111111111011111111101022211221112212222211121222211111101111a1110111111111110110011111010111111111010001111
1110100011111111111111111011011111010000110aaaaaaaaaaaaaaaaaaaaaaaaaaaaaabbbaaaabaabbbbbbbbbaaabaabaaaaa011101111a1110111111101011101011111110011101011101111011
1111011001110110111110111111111111110111110a11111111011111111111111110011221121021212122202222221002020a111000111a1111011111101111101001010111111101011011110101
1001111111111001111010111111101110111111111a11111110111111111111010001112112222022101102001120211111011a110110111a1111111111111111111111111011101101001011100110
1011011011111101111011111011110010110001111a11111110111111111001011111110001201212222201111112222102221a101111100a1111111111111110111110111111011111111111110111
1111111110011101101111111111111111111111111a11100110101111111101101111110222222021121212222002221022010a111101101a1101111111111111111101111111011100110001110111
1111101100111011011111111111111101111111010a11111111101111111111111111102001121121100022112112211210011a111111111a1110110111111111111111111010111001111111101101
1101111110111110001011111111101110111011111a11111101101100111011111101111101120112122011210201220211201a111101111a1110111111111011101010110111100111111111110011
1111111111111111111111111111111100111111111a10100111011111111111101111111210222122021022111011112012201a101011011a1111111111111111011101110111111111101101011001
0111111111111111110011111011111011111101111a00111111111111111010111111111120212212211021012121111011101a111001010a1011110101101001111111111111111101111111011110
1111110111111111111111111111111111111111111a11111111101010111111111111100122011112122102122111220202111a101111111a1101111100101111111110111110111110100110101110
1101100011101111110111111111100011111111111a11111000110011111101011110010012201112110111221021120201121a111101101a0111111110011111110111110111111011110101100110
1011111111111111010101011011111101111111111a01101010100111110110111111011211112112122212122011122021110a111101111a1111111111111011111110011111111001110111100011
1110011111111011111100111111111111111001111a11111001110111011101110111112211122211120022121221221121101a010011111a0111111111010111111111111101111010011111111001
1111101111010011111010110111111110101111111a11011111111111111110111110112012121121020122201022212122021a111111111a1001011111111101111110111001111111101110101001
1011111111111111111011011101111111010101111a11100101101111111011111111101211010222121101020220021221220a111011011a1111111001011111111111101111111101111111011011
0101011100110111111111111111011111001001010a11110111101111111111111010112212220210010211111202110121221a011101111a1101111101110111111111110100111001111111111101
1111111111111111111101111111101101111011111a11011111111111011111111111110221001221101122121201222010101a111111111a1010111110111011010011011110111101111100111111
1101111111011111111111110101011100111111111a01111101101110011110101111101211111222100110212212001212101a101111111a1101111111111111111111110101111111111110111101
1100111111111110111011110111100011111101011a10101011101111111101111111011012212221221021021120022112200a110110110a1111111011111111011011101111110110111111111110
1101010101111111111101011111111111011111100a01111111111111111111111011101122111012121121221220211100211a101111110a1111111111111111111111001011110110110100100110
0110001111111111111111111111101101111111111a10111101111111101011101011100112222112220112020100220122111a000111010a1111111110110111111011001111111111010101111111
1110110111111111111110001101111111111111111a11111111111101111011101010111112112002122121212221102222221a111011111a1111100111111111111110111111111111111110110111
0111110111101111010111111111011011111111110a11001111101110111110111100112110022101211201110101102101001a111111111a1111101101010111110111111101111111111111111110
1101011110111111110111111001101110101111011a11111010111111011111111111111110101111001112210122211212202a121220212b1121011011111110011011011001111111011011101101
1111101111111110111110111111111000111101111a01011110010100111101111111111011111010111101202012010010211b212222121b1220111111111101111110111111111111101010111111
1011111011111101111110011011100111101111011a11001111011111111111111111111111101111101111220221121220111b220121222b2101111111111111101111111111110111111111001111
1101111010111111111010111111111111110101111a11100110100111111011101111111110111111111012112020110212112b220110121a0000111001011111111101111111110111101111111111
1111101111111111101011101111101010101110011a11111111110101100111111110111111110111111012112122202220212a001112112a1121111111010101100100110111110011111110011111
1111111111110111110111111101111110111111111a00111011101111011011111111111111011111111112222212212212122b222111102a1121111110111111111111010101111001101111111110
1110111111101111101111110011111001011111111a11111111111011111101111110110101111111111112211112021211100b221101210a0111111111011111111111110111111111001011111111
1110101111011110111111111001110101111111111a11110111111111111111111011111111111110111110212022112222221a002112100b1121011111111011110101111001111111111001110011
1011111111001101100111111111011101011011111a11111110111110111101011111111111111010101011110222222112221b112102022b0221111111110011110111011100111101111011011111
1111111111101011111011111010111111011011101a00111111011110101111110101011111111111111112220202121102021b122021202a1211101111111101011111111001101101111111110111
0011111111101101101011011011111001111110110a10111110111101110111111111011111101111111111211221011122111b121120021a0111111101111111110011111111111111011101111111
1011110111111101010101111111011111111110111a10110111111111111111111111111111101001101101121222222011122a221200202b2221101111111001111111111111101111111111111100
1011010111011011111101011111111111111001111a11110111111111100111011111101011111111101112001212222210201b012012222b1121111111111010111011111111111111101101111111
1111111111101011011111111111111100111111101a11111111111011111111101111110111111111111112012021011211122b121022102a2011110011111111111110111111111111111111011111
1111111110011111111111111110111101100111101a10111011111111111111111111110111111111110112022202211120120a221022102a2221111111011111011111111100111011101111101111
1111101001110111110110011111111010111000111a10101111111111111101111111111111010111100002112201112102122b122122112b2221011001111101111111110110111111011111110111
1111111111101011101110011111111110110110111a11111111011110111111111111111011110101111112211121210112112a21002202ba2121111111110111101111101110111111101110111001
