(35,157)
(116,79)
(108,107)
(107,140)
(68,108)
(78,70)
(67,134)
(32,120)
(68,151)
(96,124)
11101a0101011111111111101111111101110101111101111000110110101100001111111110010011011101110111111111011111011111111111101111101111101101111011111a11111111011101
11001a1100111111111111111111101111110111111101111111101111111111001110111111111011010011110111110010111111111111111111111111011111110111111111111a01101011011110
01111a1101101010111001010111111111101111111111011101011110001110111101011111010101111111110111101101111101101110111111011110111111111011111111101a11011111111111
10111a1110111001001111110111011110111011111111011111111000111111011011110110111001011001111111010111111111111100110101011111111111011101101111101a11101111111111
10111a1111101010111111011111101111111110101111111111111000110101111111111110111101110111100111111001110111101110110111111110111111111101010111111a11111011111011
11111a1111110011111111110111111101111111010110101110111101111100101101111111111110100001111110110111111001001110111111110110111111111101111011011a11011111110111
01001a1011010110111101011011100111111111111111111111111101111110111011101101011011111101111111110111111111100111110101100111011110110111111011101a11111111011111
10110a1001111011011110101111101101001110011110111101111111111110111111111110111111111101011101111111110111011111010111110111111111111011111111011a11011111110001
01011a1011011000111111111111011111111011011101111110111110011111011111100101011101001110001011101111111111111111111111111111111111010100111111011a11111101100111
11111a1111111011011101111111101101010111111110111011101111011111111111111111111111111011111101111111101111111111111110111110111011111111111011110a11111111110111
01111a1011010111111010111101111101111101101011111111111110111100110110111011111110111111111111111110010111111110011111111111111111011111101111111a11111011011111
11111a1100111111111011111111111111101101100111111111111011111001001111011111111111111110111011111101111111111110111111101011111011111011111111100a11110111111111
01110a1110110110111111111111110111111111111110011111110001011111111110111101111111111000011111111111111111111111111111011110101111101111111101111a11111111110110
10111a1010111011010111111110111111101111011111111111111111111001111011011111111111111100111111110111111111111101111011011111101111001110101111011a11101010101111
01101a1111010111111111111100111000011111101111111011111110111001111110110101101110100001011001110111110011011111111111101110111111101011101111101a11111111111010
11110a0111110111001101011111111111111011110000111111110101111110110111111001111001110011111111010111111101011110101101111101101011100110111101011a11110011101011
11110a1101110111111111100101111110111111111111111111001111001111111001111111111110111111101111011001111011111111101111111110111111111010001101111a11011111011110
11111a1011111110101101111011100101111111111110111110110101111111101111111111101011111101011111111111111111211021211211021120201212211110110111111a11111110011110
10111a1111111111111110110101111100101111011111101110011111011111111111101111111111111111100101101110110111012221222222121000111121202210111111111a00111110111111
10110a1111111111111111101aaaaaaaaaaaaaaaaaaaaaaaaaaaaaaaaaaaaaaaaaaaaaaaaaaaaaaaaaaaaaaaaaaaaaaaaaaaaaaaabbaabbbaaababbbbaaaaabaabbaaaaaaaaaaaaaaa11111110011100
01111a1101110011111110101a11111101111011111110111011110101111101110111110110110011110001111111111111100111122121202111022121122210202220111110111111111110101011
11101a1001001101011110111a11111111011101111111110111110110110101111011111111101011111111111111111111111010212022200111110212222221212111111101111111011111110110
11111a1111111111011111011a11001101110101111111100111111111111111111111101111010101110111111110111111111012220022102020221202121121112111111001010011111111101011
11011a0111111001011111111a11111111011111001111111111111110111011011111011111111111111101111101101111011112102122022212210002021212211121111011111111111111111011
10011a1111011111110011111a11110111111111110010111000111111111111111011111011111100111101010011111111110011110212021111202122210221122201111111011110010101111111
11110a1101011010111011001a01010111111111110011111101101111111111111111111100011110001111111110111111111101111102121100222002000111101211110111010101110110111011
11111a1111101111111101011a01011110111111111011110101111111111011111101011111011111111111111111011111111110122021102212212000100012100020111111011111111110111111
10011a1111101111101101001a11011101101111111111111111111111111100110110110111111aaaaaaaaaaaaaaaaaaaaaaaaaabaaaabbaaabababaaaaabaababbbabaaaaa01111101110010011100
11110a0111011101111111111a10100101101111110011111111111011111111011111111110100a10101111111110110111111111220121211011212200202021000221111a11100101000110111110
11011a1110111110111111110a11111001101111111101110111111010011101111110111000110a11111011111111111111111112111120202002122102212011011021111a11111101101110110111
11111a1011111000011111011a11111011111111111111111101101111111100111111111010111a11011111101111111111001112212222221122201222120220222110110a11101011011110111111
11110a1111110111011111111a11111101110111111101111110110101110111111011111111101a11011111111111101110111112110211122100112000210111221001011a01011111011010101111
01111a1111111111111101111a11111111111011010111111111111111100111111101110100110a11111110100101111011111111201221210101202011111111122021110a11111111111100111111
11111a1110111111100111110a11001111010101011110110110101110101101010111010111111a11110111111001110111110112021221212121120110122021122111110a01111011111010101111
11101a1101010110111011110a11111101111101110111111110010111111111101011111111001a11111111111110111011111112112111101221212211001121121010101a11111111011101111111
11111a1111111011111111011a11101001111111011111111110110111111111111111111111110a01011111111110101111111111101220102112102011000212022121011a11111101111111111111
10101a1011100111111100111a11110011010101111101111111101111011111001111111111110a10110101100111101001011110222121121211121211121211122111111a11110110010111111111
11111a1011001111110111110a11111111111111111111001111111110111111010111010000111a01011111111010101111011111122211102012201012212122111110110a11111111111111111001
10011a1111011111011101101a00111111111111111111111111111011101101111011111111111a10110101111111111111110112121111211221020211011222111220111a11110111111111110111
10111aaaaaaaaaaaaaaaaaaaaa10111111111111001011010010010001111011011011101110111a11111111011111111111111000112122022100012220011122002200111aaaaaaaaaaaaaaaaaaaaa
0011111001111111011111111111111111111101111011111111011111111111011101101011110a11101111111110111111011012102021202200001112122022221211111aa0111110111111100111
1011111010101111101100111110010010111011101111111111111111111110011011111111111a00111101011111011111111112202001201212121211121212211201111aa1011110110111011110
1111001010111110111111100111111101111110001101111111111101111010101011111111011a11111111111111111011111011120102120121021210120121121121111aa0110110111111111111
1111111111111100101110111011101110111110100111111101101111010111110101111000101a10111111111101111110111100000212121100101212122011111220011aa1110111111111111001
1111111111111101111111111101111111111110101101101111111001101111101100111111101a11111110101001111110110112102212211122120120221201112201101aa1111110111111111111
1111111111010100111111011010111111111111001010011111011111111111011111111011101a11111100011111111101111112211111122112222201202200201120100aa1101111011111011111
0011100001111111011111011101110110101110111111101111111111011111011111101110111a11111101111111111111111112102221212122011122112102112011011aa1111111011111101011
aaaaaaaaaaaaaaaaaaaaaaaaaaaaaaaaaaaaaaaaaaaaaaaaaaaaaaaaaaaaaaaaaaaaaaaaaaaaaaaa1111111111111010110aaaaaaaaaaaaaaaaaaaaaaaaaaaaaaaaaaaaaaaaaa1001101011111111110
111110111111111011001111011111111100101101111011111111111111110010110111111111111111010111111111101a1111111110111111111111111110111110111111a1101100111111011111
100111111011010111111111110111110011111111101111111111111111001111111110110111111110111111111111011a1111111111001101111111111111111111111111a1011100110111111111
111111111011111011101111111101111011110101111111111101101100111110111111111111111111111100111111111a1101111111101110110001111101011111111101a1101101111110111001
111010111001111111111111111111111011111111101011110111011010110111011111111110001011110101111111111a1111111111111111101100111110010111111010a1111111111111111001
110111001101111111111110011110110011111111110110111000011111111111010111101101101101011111111011111a1101011111111100111220121221122110011210a2121111101011101101
010111101111111111110111111001110101101110111111111101111111111111111100101111011111101111101220121a0211020200001221121202200110101212021202a1221022110112112110
111111111101111111100111111111111111011011111101111110100110111111011011111111011111101111011120122b1120122021202210121222202200012011220122b2212212112101211121
111111111011011110111111011011110110111001111010111111111110111100110101101111101011111101100110000a2112211021112120221222212101211110120222b2210222212101010112
011111111101111101011010110111111110101011111111110111110111111111111110101111111011111100110210210a0002112112101122010202221212022121222222a2221220022121020221
111100111111001110111011111111111111111110111110001001101111101111111111110111101111011101111211222b1102011121102020212221220122110120212001a1222221102101201211
101111111111101101111011111101001011101111111111111111111110111111101111110111011011011111111221121a1101121011211121011221202112221122201022b1220212220020211011
001111110110111011011111111111111101101011101011111110011101111101010111010111111111111111110212221a21221212221122022122bbbaababbabbabbbbbbbb2222202020221021221
111aaaaaaaaaaaaaaaaaaaaaaaaaaaaaaaaaaaaaaaaa1111111111100111111111110111110011111111101101101020101a11010012120102122111b211211011112221202202121222112222111020
111a111111111111111110111011110011011010111a0111111110111111111100111111111111111101111011111202220b02211202112102111212b111111111122212020200022212201112010121
001a111111111110111111111011100011111111011a1101111101110110101011110111011111110111111110101202222b01122201002001102120a002011212002022222220020202212220112121
111a111111111101101011100111000011111101111a0111111110112111011111021222202221212221211101111102101a12110210222221121210b020221222122111120222201010022111121222
101a011111111010111111111111011101111101111a1111111111120102111212012222011020120111010111101212212a22121020101222122122a222112112221122222212202201221112211010
110a111100110010111110111111110101111111111a1001011111121202221112212210122211112011211111111100201a01100120221222211101b222212210110002011122222221022020222222
111a111001110101111111101111011011101110111a1111110110111202122001112111122122121102101111111212111b00120202122001021020a222220120112222221022122222201212112222
011a111101111101111111111110011011111111111a0111111110102101121201121100212022112200111110010121212a20102012112011212022b222112221211102122221220022220100110111
110a111111011111010111111111111111011111011a1111111111112102122112201022212121121121111111001221221b10222012211102021002b220022122202011222222022022220200122121
100a111111110111101111011111011101100011101a0111011110112111111110112022222211220211211111011112111a10211202212201222120b210111222002021222120212202110121110122
111a110111111110111011111011111101111101011a1111011111122212012221000122201221012120010011011110212a21212101122112210101b212002120111212212022201022022111011221
101a110101111111111011110111100111001111011a1101110101011200022002021002221211210102211011011210201b20122102221010122212b202112020222202022202221111211212222102
001a111111101111111111111111111011111111111a1100111111121112202222220101010110122222211111101222220a10121021110211222122b121112201222121122200122202222202210100
011a111111001111111111111011111101101001101a1101011111120222211022011211020120122202111111011210221b00022022121212110112b212002221201022102222212122102212211120
101a111110100011111111111111111111101101010a0111110111102210022122220202210010212022211011110111012b21111201221122012210b200111011002200220122222120021110022222
010a111111111001111111111100101100111111001a1011101011101021022101222021002010221202201101011202220a22021101121122212222b202210222122102022222112210001120222211
111a011110101101011011011011111111101111011a1111101011010221100011211121102121210101111111011100210b02011110101221222020b022221102001201222002210202221110111212
110a111010101111111111110111011111101101111a1101011111111121022100211102221100202200211010111110102a20111222222222021002b201211221011210121210122211211220012012
110a111111111111011110111011011111111111101a1110011101122111122120200100212202012222211111110101211a02221001222211111122a221221222201011121222002212012122111112
110a101011111111101111111111011110011111111a1101111011121210010120212101222110221122011110111122121a12222222022010221202bababbaaabaaabaabbbbbbabbbbbbaabaaabaaaa
111a101110111111111111011011101101011111101a1011111011102211212122111121112012222111101110111210211b201002202121222111122221111212212212002122220222112210102202
110a111111110110111101000011101111111111110a1100111111102202212021111210222221122011011000011211221b211220121122022100020222222102222220222022121222021212020022
011a101110110110111111111111111011111010111a1101111111100111021201121212221221122110211110101111110b222111122022222211001221202122101222122222222121112122211222
101a011001111111111101111111111111101111111a0111111100112212222122221111112021221211200111111111101a111101110011212212020222022021021221110111110111111111110110
100a111110011101111100010101111111011110111a1111111111101022021122202211222221112122211111110111111a110111111202012001221222122121000111001111110101111111111010
111a111101111111101010111101111111101100111a0111001111112210202222222022122011212221201110100111111a001111011111212102212012102011011122211111111111111111111111
111a110111111111111011111111111111111111011a1111111111112212002222112120012011122021211111111111110a111011101011102211111210212210212221212011111001111111110111
111a101011110111101111100111111111110111110a0101111101112222221211021121020012122022111010110011110a011110111101221212222022222210212200221001111011110111010111
111a100111111111110110110010111111100111101a0111111010112220122021011121201202222121111101101111111a100111101212021111220211212221221122022111111011011111111111
111a111111110110110101111111111110111111011a1111111101011101000011220001112210121221111111111110111a111111010020122220010200211100011211220111001111111110111111
111a110110110111111111111111111111110111111a0111011111102102120211001112201111122221101111111101011a111101111202212112220112212211001121102111110110111111110111
111a111011110111101111111111111111111111011a1010111111101120112211112202211201212221111111110111111a111101111212222012221021110122202011012100111011111110111011
111a111111110011110110111111111110001101111a1111111110012210221120102220012220222102110111110111111a111111111201111220221222102202222022122120111221122112211011
111a101111111011111111111111111111110111010a0110111111110110111100110100000111111111111001101212110b102202221220202202020221121221122201221022022002012221111101
111a111111110111100111111010111101111111111a1001110111110111110111111011101111111101011010011112211a210021112200121220202211222220212210222221102100201101210101
111a111111010001111111011111110111011111101a0111111011111111010111111010001111111111111111110212112a111201212121220220222002222222022122222221210111211202210111
101a110111100110111111110111101111110101111a1111111110110111101110101101101111110011110111100112121a222112111210220021222210222212122222212001011212201202111101
111a111111111110101110101111101111111101111a1111111011111111101101111111111111011011111111111121122b212211121222210122220012200122122022222111222102102221211001
111a111110100101111111111111111111011110111a1111010101110011111111010111111110110111101111110002001a202121210210122222221012202122222222112222021101211120201111
100a111110011110100111111111011101111011101a0111111111011111001011010111111111110101111111011222121a121020110200212122221202102210220212220122122122122212201111
111a101111111000101011010011111111110111011a1111111011111111111111111111111110110111111110112102222a021212012022220212222210012121122220222221122022222101211101
111a110101111111111101111011111111111001101a1111111011011101001111101001001011111111111111112112120a220110221022002102212212021220112220200011201101222211211111
111a011101101111111111100111111011010111101a1101111111111111100111111011111111110011111111111022112a012121120222000202102222122222100222220221122121222222101111
111a111101011110111011111110111101111111111a1111110111111110001111101111111111111110110111102121021a211021222212202222202222122222222222212221111222120202111110
010a111110001101110110101011001101111011011a1111101101111111101111111000111111111011101111112211122b222002122012221102210001120122222210201102102221122021211111
111a101101011001111001111110111111111111011a1111110111111111110010011011110110010101011100111222122b121222112220212201122111222222221220220211002212221212111110
111a110011111111111111111111011011110111011a1010111111101110011011101011111111110110111110110121220b112211121211200222222211121102110222222001021201212111210111
111a011111011010111110111100111111111111111a1111101011111111111100110010111111101111111111012100211b101221222011221221122222220122022211212102212222112212101111
111a011100011111111011111111111111111101111a1111111110101011111011111101111011011101111110112222211a110011120222211122102202121201202212122110102221211121010111
111a111101111111101111111111111100011111111a1111111111011011110111111111111101111111111111111220222b111112211201022202122201122222102202220211112221020122111111
111a100111010110111111011111111110111111101a0011111111101101000111011101111111101111111111112221101b221211210001202200222120102202122202220220112211101022111110
111a111011111011100111111111111001110000111a1111110110111111110111111101111111010111110111111202021a222022202220202222122211111001212021101222222122120012100101
100a111011111111111110111111111111111011111a0111111011111011101111111010111111111101111111112211211b212010110110021012012210112220021101212211201022221011211111
011a000111110111111101111011111111110111111a1111110111111111111111111111111110111111111101111001012b121102111211222122112211121221212021222222111211121122110110
110a111011101110111111101111111101110111110a1100111110111111111101011111011101111101101110111111200b021022110222202202110011101212222012212220210120010212101111
111a101111101110011111110111111010011111010a1111011001111100101010111011110111111110111101012101021a221112201221202121111011121212122021122211101222111121201111
111a111110011111111111001011111110111111101a0110110111111110100111011001100110110111111011010120102b112122210022021112102111100212122121211120121221122011010010
111a111011111110100111110111111110101101110a1111111101101110011011111111010110110110111111111022122a121112202220211021011111122221101111212201222120122211111110
111a110111111111011011111111111101111011110a1111111111111011111110110111111101001111111101112121112b111012010111010112022211121221102210110010211121212111111110
111a101110011110011111101110010111111111111a1110111111011111111111111111111111111111111001111212121b212212011212111020211011102211200112201121212011222221110110
