(8,92)
(118,111)
(92,3)
(50,146)
(75,130)
(47,98)
(27,9)
(45,79)
(44,33)
(46,15)
11a11011111111111111111101111101111111111011100010111111011111101110100110101001111011111111101111111111101a01111111a1111111111111110101111101010011011111111111
11a00111111111110111111110110111101111110111111111111101111111101100101010011111011101101111011101111111111a11101111a1111101111101111101101111111101111111111111
10a10101011110111110101111100111110111111111111111110111100111111111111111101011011110100100001111111011011a11111100a0111111111110111111110001101111111010111011
01a10110111110111111111111111111111111111111101100111101111111111101111111101111111111001111111111111101111a11001111a1011001111111111111011000011011001111111101
11a10111111111111010111111111111100111110111111111111101000111011011110111111111011111111101111011111000101a00111111a1111111110001101111011110111111101111110110
11a11111111110111001101011111110111111111011111111010100111110111011111111111011111111111110111101111101101a10011000a1111111100111001111111101111111100111101101
11a11011011101111001110100111111111111110100111101001111111101111110111011111111111011111101111111111101111a01111111a1111101111111111101110111111100111001111111
01a11111010101111111101111111111111110111111111101111111111100111100111011111110111101111100111101110111111a01110110a1111100011111111111101111101111011111111111
11a11011111011111111111110110111111111111110111110110110111111011111001111111110101101011111111111111110010a01111111a1100111110101101111111110111110110111110101
01a01111110111111011111110110111111100101111110010011101111111111111111111101110101111110111111111111101111a11111011a0101100111111111110111111101111111110011011
11a11111111111111111111011101110001011111111110101111100110111111011111101111110111111111110110111011111111a10111010a0111011100111101110111111101101111110110101
01a11111101111111011110111111111111101100111111111111110110111000101011101101011001111111101111111111101110a11111111a1011111000111110001011111011011111111101111
22b22202210112022001111111110111111111100011110111111111010001111011011011111111110101110111111111101111000a11010011a1111001111111111111111111111111011111011111
21b11220202010211220211111101111011111110011111111110101111110101101110101100111111110111001111111101011111a01111111a0110111011110011011101111011111111111111110
11b21211212110212010011111111010011111111101110111010111111111111011001110111111111011111111011001101011111a11111011a1011111010111001111011111111111101111011011
22a12211101011121121012201111111111110111101011110101111111101110010111011011110110011111101110101111111100a10111111a1101100011111010110101111101111101111011111
21b02121221101121122012011100111101011111111111101111110010011101101101111111111011100011111111111011100101a01010111a1111011110111111101011010011011111111110111
22b21210201212012102111111111111111010011111011110101010111111111101101111111111011111111110011000101010110a11101111a1111111110111111110111111101111111111111111
11b21022111002111211122010100101110110111111101111110101011010001111101111111111101111111101110111001101010a11101111a1001111111111010111111111111111001111101010
01a11122202200221212212111101111111110011111111101011111101111111011111110111101111101101001111111011011011a11111111a1111011010111111110101101111100011111101111
02b11201212220211200101110111110001110101011111111011011111111111111111110110101111110100011111111101111011a10111011a1111111111111110010111111101011111110011111
11a02122211211112012201211111111111111001111101111111110001101111110111111101111111011011111101111111101111a01111111a1111101011010111111111111111111011111111111
11b00201222202120012212211111111111110101111111010010111110111100110010111111110111111011111101111111111110a11111111a1011011111101111111111111111111111111011101
11b12012022112212112212111111111110110111011111111110111111011111101111111011111111001011111111101111111101a11101111a0100110111000111101111111111101111110111111
21b22120111011210011211111111011111111011110111011101101011110111011111111111011111101111100110111111111111a01111111a0011101001110111111111111111011010101010111
22b22021101121111111210111101101111111110111100110111111111111011111101101110111111111111111110111101011001a11101111a1111101111111101111011111011101111111111111
10a22000201111111222210211111011111111101011011101111110111111111011100001110111111101110110111111011111011a11011111a1111111011001101111011101011011011111111111
02b10122001222122022212211111111111111011111010111111111110110111110111011011111011111100011111101101111111a11101011a1111111101101001111111111111111111101111101
21a21201122002111112222211111111111111111111010111011110010111111111111101011100011001111011111001110110111a11110111a1101011111111111111111101011100101111111111
00a21021010112202222222021221211112212022221012001111111111011101011111111000111011111111111101101110101111a01011111a0110110110111101111111111101110111110011011
11a10222120112111122222110202102122202221122212210111111111111101221122111202121100020110122111111011111101a11111000a1111111111111110110011110111111111110111100
11a20120121122021022122010211221112012012220221110111111101111112121121202022102022101200122221110111101111a11111110a1111111111111111111101011111111011111111101
20b02022222122212020222222222222220220102222211211111100111101111022212222011220010022102220221001211011211a20202011a1001111111100110111111101011111110111101011
10a22102220212122200022202222111022112121212202111010111111011102122112202122122202122000222222110202011221b22001011a1111101111111110111111111111101011111001001
22b20211222122211222222222112210102221102221212011111110011011111120122121112111101022201212120110222100202a21122111a1111001100111011101110011101101111111110110
12b12222022222122222020200220011221221112111221111110110111011011212222021112021112222112122122110001111112b02111111a1110011111011112222221202202122012012122120
20a12222002212012202221201202202001110022012110211011011011111111022222102222111122221212211221202112221212a22221110a0001111011111122212121222110100002220202222
22b12120211221112001222222212221110111222211121111111111110111112121202201122220100120222220120212211221102a11210111a1111111111111112020011021012202121122112100
22b22222202122222021222202211212212222120112211211111110111011100221011211222201121220221220222120221222121b21102111a1110111010110100001211211222202111112201102
01b22121222121021220212002011202110101121210211211111101111111100222122001201220101222221222202100010121102b12022110a1111101011110121220111201212112120211021001
21b02212112022110200222202222021221202122111000211111011110111100212121202122112110022020201210102011101111b12221111a0111111011110112220011112222121012121210002
12b02122202100122022022202022211210120112100112011011101111111111222101210121211112222222122022121001112221b21012111a0111001011111121122100122002211010222212111
01a10021001222111122122112102211221212110112112010110101000000102111220120011202101220221202020112012121212a21002101a110aaaaaaaaaaabbabaabababbbababbabbbababaab
11a10221222211201220221200122012011220112021221101111110011011111012110220101102012212222220220112120022011b21011110a011a011111111111102200221211202001221200021
21a21002212112111122222102211222121211221221021211110011110111012111001212121122102222121000220220011120012a22211110a101a111111111022211022211101122102111111101
02a21212200222112022211100122202110221211211000110111100111111112211220011121121122002022222220221101010100a00120111a111a101110111101111222112121001112212221111
01b12221211221021102220100020122022102212211011211101111111001112222210121102020201122021222201122220101210b20121001a111a011111111102212110021012100210201222112
21a21102022220111220002020022210121021121112202211111100011101112020222021200112221201221102200111212110101b20121110a111a011111101121212122121012212222222221101
01b22012112020011122222122022211022110111111201111111101101111110120121102122111222220221011201012122211012a22022111a101a111111011111121112211122100111210120202
01a22111102010010221110121012201220102011121212011111111111111111102121111201111112222120022020220021112212a02111111a010a001111111022112100210211001222211120201
20a02212221121102120122212222222221121212202202211111111011111111111121110212212221222122221221112200100201a22220111a111a110111101022222222111202220111111201021
10a02210110222201122120020122220112122011120122201111111111111111111102211122201011222022212111201022121122a01210110a111a011111110112111112121222122021101222111
21a21010120212211201221222222012022122110211022011111111111110100211212101021110212222210222222221111122220a22221111a111a111111111112212010121010022221212121110
21a21102222010201222222202222122101112022201212211010010111111012212122211102220122212121121221112212120221a11111101a111a001111111112011222211222022211210210202
11b02202021121122222210210211210221202210222121211010111111111010121221120222200122120021202220100022110002b21121101a111a111110101011111121111210121121120121020
21a21120101120221212222122120210121201121010002110111101111111112221200111010012102222022120221221112121222b21202110a010a111101111122211101112210012211102222222
11a02022102121022122200222222212222212201121222111101010111111110221110222221112112022202122220012111121122b10101111a111a111111111122002221101120100201222210021
20a21220122021211122121122212001122022121120001011101101111111112111021112122212102222222212211121212202020b12122111a111a101111011112111211102122222211211112122
22b00222022010001002022022222221011222110110000111101100011011111020022002012221021121212222021112212222112a21211011a111a011101111112022001221222002011220221212
22a12122202011111102011212022101111111101111111111111100110111110121222010210102112212201221210121221020122a11020011a111a101101011021021121211112110002212221011
22a02221202110121220212212012211111111100001111111010110111111111111101111011111011102111200121212121020122a21122002a111a122211201120011222022202111020212110222
11a11111111001111111111111011111111111001011111011101111101011111111000101101101101112120021101010120202222b02112112b122a210111220120022120002221220122111211222
00a11101011111011111110011011011010011010111110110111111011111011111100110111110111111101011111111011011011a11111111b022a012112022112222222200012201111212111212
01a11011111111101111111111011011001111110111111111011111011111111111011011011101101110111111111101111111111a11011011a121b201210222122212222212120021212221112112
10a01101111111111011100111111011011111111111111111111110111110010111110011101111111111110111111011101011010a00111112b101a102111222202222122222002222011211110122
11a11111101111011101111111111111011111111111111111111010111111111111111001100101110111101110010011111111111a11001110b021a100111122220202112020122011101011011111
11a11011111011111111101111111111111111111111111111111111111101111111111111110011110111111011110101111111111a11101100b112b200121121122122102112220101110111100111
11a11110010101111110101111111111110110101101101001111100111101111111011000111010110111011111111110111110011a11101112a111b211210022022212201101211111110111101001
10a11110111010010111110111001111111111110111111111111001111010101110111110111110101111111011111011111111011a11101010b120a001121111211112012112122111111111111111
10a10111111110111111101101111111110111111101110011100111111111111111111111010111111011111101111111101110111a11111110b221a221211120112112222011220111001110100111
11a11111110101010111110111110111111011001011111101101000111111111111001111101101111111111111100100111101111a11111011b011b222022212112112112212120111111101011011
11a11111111011111010111011111111101111111111111101111111001011011011111011000111111111111110111111011101111a11110100b111a121211221212021211221221111111111101101
11a11110111111101110111111111101001111110111111110111111111001111111011111011111111101111111111111111110011a11111111b201b121212021212012201211112111111111110111
11a11111111111111100111011111111011101111001011111111011111111011111111110010101110111111111111100111111111a11110102b012b220121212202121210111112011011101111111
11a01111011110011111111111111111111111111111100111111110111111111011111110111101110111111111111111011111110a10111012a111b102211011212212220111020111111111111111
11a11101111001110111111011111111111110100011111101011111011110111110101110111111111100110011111011111111111a11111111a112b221201012222121022221121111001111111001
11a11111111111111111101111111111110111111111111100101001111111111111111111110111110111011011111111101110111a11111102b112a022222220102211011201211111110101111110
02b21221111112211011111110111110111111111111111101011111111011100111111101111111101001110101111111111011111a11111012a110b122102212011201012201222011101101011111
20b02120102120222011011101111101111111010111111110100111111000011101101111110011111101101111111111111001110a10111110b221a022122022121020222211012111011110001111
12b221211210222101111111111111111111101101101111110001001111011111111011101111101101101aaaaaaaaaaaaaaaaaaaaa10111102b110a101111201210220112211222110111111111010
22a220211111212220101111110111111110111011111110101111111101101111011010111111100111111a1101100110111111111110101112a101b202211211111112112111021111111111111011
10b211212121002212111110111101011111101101011100111111111110111111111111110111111111011a1111111101111011111111010112b112b121201211111120221121201101101101111011
11b011222220022022111111111110111111111101101111101100101101110111011110111111111011110a1111011111111011100110111101a212b121222000120211100022111111010101100101
22a121021222112211111101111111111011111111111010110111111111111111111111101001101011111a1111111111111111011110111111a212a112112111122012020002221011111101111011
11b201200112111122101111101111111111111111111111110011111100101011101111000111011101111a1111100111111111111101000100a102b212112101111121220202202110101111000111
22a101012211121122101101111111111011110101111101101110111111000110110111111111111111010a1110001110101111111110011112a121a121010120202222122122120111101111011011
21a211112120111212111101111100111110111100101100111111111100100111011101110111110011110a1111111111110101111101010102b111a111111102022012202221022101111111111011
22a122102021211221111111001111101011101111011111111111101110010101111110111110101011110a1100111110110101011111010012b111b111202021120202102212022111111101111111
21b012021120212011110111110111101101111110011110110111111111111110111111010011111101111a1110111101111111111100101110a212a211122210121112221222102001011011111110
22b100102121112122111111111011111111011011101011111001011111110111111111111011111111101a1111111111111011111111001111a201b100110012002201121022122111010111111110
21b212212110022110111111111111100111011111111111101111111111101111111011111101111100111a1011011111111111111011111111a111a111111111111011111101110111011111111110
12a202122212021122111111110101111111011110101111101111100011111111011111111101100111110a1101011111111111111110101111a111a111110111111111111111111111011110110111
10b002111111212002011011111111111111101111011101111111111101111011101110111110110111101a0111111111111111111111111110a011a111111101110110111110111111111111110111
22a222111112221012111110011111110101111111110111111111111110111110111101011111111111011a1111111011111110110111011110a011a111111000001111110011111111011111111110
22b011221022210210110100110001111101111101111001101111111011000111111111111010011101011a1111011100111011101111111110a110a110110110111111111111110111111111111101
12b111220011022221111101101111111111111111001111111001110110111111101111111110111001111a1111111010111011101111111111a011a111111001110111011111111111111101011111
21b212220201110022111111111110110111111111111110100100111101111011111111111110111101011a1111110110111111101111111011a011a111100111111011110111101111101011111111
10a111220211202211111110111111101110101111111101110001111111111111110110111111111110111a1111101111110001111110011011a111a111111111111111101111111101111111111111
11b210002200211221111011111011101111110011111111111110111011100011111101011011111001011a1110111011111111101111101111a111a110011101101111110101110111111111110111
22a111121011102021111001001111111111111011011011100111110110101111111111111011111101101a1111111111101110101111111011a111a111011111111111001011110101111011011110
12a222222122222011111100101111101111111111111111110111111100010111111111111110111111111a1111011111101101111111100111a011a010111011001101111111011101111001111111
12a211212012210221101111110110111101110111011111110100111011101011101010111110111011111a1111010111111111110111111101a111a111111100111111101111111101111011111111
20a221102201120222111000101100111101111111111111111110101100001111111001111011111111111a1111111110001111101110111101a111a111001111110011100111111111111111011111
22b221111211021102100111100111111110111010110101011011011111011111111111111111101111110a1111111111011110111010111111a110a111111111111011010111110111111011111111
12a211222012210110111111111111101111111101111011111111011111111100111111101111111111111a1111011011111101110110111101a100a111011011111111111111111111111111111111
22b011212122111101111010111110111011111111110111111111111011111111011110101111011111111a1111111110111110111110111111a111a111100110001111111111111101111110101011
22a102211111120011111110101111111111101001111101011110111111111111111111111101110111110a1111111111111111111101111101a101a011101111111111111110101101011110010111
11a101111111011011011111111001111111111101101111110101111111111111110111110111111111111a0101101111011101111111011101a111a110111111101110111011111111011001111011
11a111111101110101110111001110111111110100111101111111101111111101110111111111111101111a0110011001111101111111111011a010a111110111111111111111110111111111001111
01a111111111111111111111111111111111111111111011111111011111111110111111110110111010111a1111111101111111101010111111a111a011111111111110110111110111101111111111
11a111111111111001101111101110111011111111111101101111101110111101111101101111101111111a1111001101011111111101111101a111a111011000101111111111110011101111111111
11a111111111101110110111111111110111101101101111111111111111100111111111111111111111111a1111001011111111101100011101a110a111111111001110111111100101111111100111
11a111011111111111011010111111111101111111111111111111011011110111111111001111111111100a1111111111110111010101101111a111a111110111111111111111110100101111111110
11a111111111110110111111111111111111111111110111111111101111101110111111111011111101111a1111111111110111111011111111a000a111111111111110111011110011111110011111
11a110111111111110111001111111111110110111011111111111011111011111110111111001111101011a1111011011111101111011111111a100a110111111011100110110110111110111110101
11a011011111101011111110111111111101011111101101111111111111111111111111011011111011101a1111111110101111111111010111a111a111111111111111011011110011011111111111
10a111101111011101111101111001101111111101111111111111011101111111110010111111111111111a1111011111001111110011111111a101a101111010111011010111111111111111111111
11a111111111111110111110111111011010111111001100011101011111011110111111100011011101111a0011111110111100001111111111a111a111111111010111111101000110101111111111
11a111111111111010101010111110111111101111110110111111111111111111101111111011111111010a1110111111111110101111111011a110a111111001111111110101011111111110101111
11a101111110110111111111111011111110011111101111111110011111101111101101101111101111010a1111111111111111110111111011a110a111111111111111101111101110001110110011
