(52,150)
(97,4)
(56,3)
(10,108)
(63,96)
(30,121)
(85,34)
(54,10)
(84,116)
(97,96)
1111101111111111111111111111110101001101111111111110110110111011010111111111101111111111011012122212121011112111102221202200111111101111111110111111111011011111
1111111111111011101101111101111110111111111110111110111101110110101111111111111011111111111111212021012111112012102120201211111111111111100001000111110101111011
1011111101111111101111111111101110101111011111011111101111111101111110111111101011111011111011111101101211111111112222212101111111111010011100101101011101011111
1101111111101110011111111111111011111101110111111111100111101111110101011110011111111111111100212202020011220022021111210101111111111110111111111011111110111011
1011111101111111111111111110011110011111011111110111110111111011101111101011101111111011111011012222000011212111122021011211010101111110011111101111111111111110
1111111001100111111111111111111111111111011111101101111011101111011111011011110111111101111112211012012111212111012111021221001110111111111111111111110111111010
0101110011011011101111111110101111011111011011111111011011101111110111111110111111111011101110222121002222121011121212222111010111111101111111111001111101011111
1011111111111101111111111111100101111001100111011101111101111011111111010111101101111111111101112210212212012210212212221200111110111010111011111110101101011101
1011111101111111011111111101111111111111001111111111101111111111111111111111101011101101111011222020021122202011212012002221111111111110010110110111110111111011
1011110111011101111110111101111111111111010111011111110001111111111111111011110111111111111012020121010011021220102120102201011111010111110011111011011111110111
1111011110111011111011111011111100111101010111000111110111101110110111111111110111101110000012201222122021222122100010101220111111001110111111111111010111101111
a111101011110111111011111111111011111101011111101111110010111101111101111111111011110111111101112122120010100212022222112011011111111111110110011111111111111111
aaaaaaaaaaaaaaaaaaaaaaaaaaaaaaaaaaaaaaaaaaaaaaaaaaaaaaaaaaaaaaaaaaaaaaaaaaaaaaaaaaaaaaaaaaaaaabababba21202112122222002211110111001111111111011111011101111011111
aaaaaaaaaaaaaaaaaaaaaaaaaaaaaaaaaaaaaaaaaaaaaaaaaaaaaaaaaaaa0101001111101110111111011101111011121222b21112112122212102211121110101111111111111111010101101111011
11111101111111111011111101111111110101101111011111111111111a1111111101111011011111011101110112202111b10122122120020222111211111111101111101110110111111111111101
11111111010111101111011011110111011111111101111111001011111a1111111111111010111011101111111100221112b22112022221212200222222111111121210111111111101111011111011
11111111001001110011011111111111101101111111110111101101011a1011111111111111111111101100111110020021b20102110021202222222220111112222122011111111010011111111011
01101111101111101001111111111111111110111111111111010111011a1111111100111111111111111110111111222212b12112212222220222220202212201221102100100111101111110111111
11011110111011100111111111111110111010111111111111111111111a1111111111101111111011111001111011121001b01121222221122220202220111222222111111111101111111111111001
01011111110101110111111111101100101111110111111001111111001a1111100111111101111011111111111102101120b12200121122211212220022211221212021101111111111111111111111
11101111111111111111011111111111111110111101111111111101111a1100100110111101111001101001101111212112a11212220011022222222201210121012222111111000111111111111111
01111101111111111110110111101110111101111011110110111111111a1100111110111110111011111101111102210002a22120122101211220220212102221221100110111101111101111111111
11110111111111110111111111111100111111101011111110110100011a1111100101111010101111101111111110202121a12111222222222201122022210201102022111011111010111011011111
10110010111100111011111101101011111011010111101111110111111a1111100111111111111101001100011111200110a22212122022122222222122200221112101101101111111100101111111
10111111111101010001111101111111111111010110111111111111111a1100111111000101111111111101111112221201a11122112002101222210221011110012111111101100011111111111111
11010110111111011011111111000110100111010011110011111101010a1000011101111110111110111111110111111010a11101220122021021121111002220020102110101011111111111111111
10111101101111111111111111111101111101111010111111111110011a1010110111111011110010010111111100111100a10111212111222110011201002212102122111111111001110101111111
01010111111101111111111111111111111101111010011111111111111a1111111111111100101101101111100111010011a01111120101010222112102122202220201011111111111111111010111
11111110011111111111111111101101110111110111101011110111011a1111101011111110110111111111011110111011a11111221202012011122121112112011221111101110011110011110111
11111111011010111111101111011111100111111001111011111111110a0111011111111111111011111111101111101111a01110220121020001222110202212100111111111110011111101111111
11101001011100010111011111110111010011101111110110111101011a1111111111111111011011101111110111111011a11111120011122222220212100111201021001110101101111111111111
11111100101110110111101011111101101111111111111100111101011a1111110011001111110010101101111110111111a11110011001121220221221200021122200001111111110111011111111
11101111011110011111011111111111111101110101111111110100110a1011111111111111100110111111111111110111a11011112111202020112011122112112121111110111101101011111110
aaaaaaaaaaaaaaaaaaaaaaaaaaaaaaaaaaaaaaaaaaaaaaaaaaaaaaaaaaaa0111111001111111101111111110101110111011a11110212121111211212211122221222212101011011111010111111111
1111111101110111011101110111101101111011101011111111111110111110111111100111101110111111101111101011a11110100011222112102212212200121112011111111111101110110111
1111011011011101010111110111111011011110101111011111011101111111101011011110011110110011101111110110a11111122102221210201211220210011011111001111101110110011111
0101111000111011111111110110001111111011111000111110111111111111111101111011111011011111111111011111a01111122211202210012012022102222101001111011111111111111101
1111011011110001111111111110111011100111110111101111010111111011111111101111111011110111101111110111a10101202201012011111111121122222001111101101110110111111001
1011111111011111111111111111110111101111111011011110011111101111101111101111111101011111110111111101a11111101211112111222121112121202102011111111111111111001011
1021220211002222022200022111011011101011111111111110010111101111110111111110110101111011111011111110a11111122112221121211211001110112111111101111111101110111111
1212220111220111121201111111110101101101111111111111111011101111111101001111011111011111111111101111a11111222021221122102210011211220121111111111101111010111101
0222102122211220222212012011011111011110111111111100111101100011100101010111111010011010111011111110a11111221101121120211122021221110222111111011011101111111111
2222120022021222221011211111011111111111110111110111101111111101101111101110111110111011111011111001a10110222122111011221111002221211211000110111101101100011111
0222022022020220221210102111111011110111001111101111001111100110100111111111111110111111110110111011a11111200200221212222221122221021012011011011111111111111101
2212200212220221222122110111101111101111111111111001111110111111111111110101111111111000111111111111a11111111110222101002112221120222121011111111111010111010111
2202020222221122220002212111101111111110111111111101111111110111110011111101111010111111011110111110a11011111100111001111001001011110010010111111111111111111111
2212202002212220222102101111111010110111101010111111011111101111011111111111111111100011110111111110a11110110101111111101011011110101110001111110111101110110011
2122211201112122001012011111101111111101101011011111111110100111010111111111101110111111111101011110a11111111001111111100111101111011110111110001111010110010111
1122202000202100101220121110111101111111111111111111111101010111111111001101111111221212212221122210b21222222111101101110110111111111111101011111110101111101101
2222022112122221211122220111110101010111111111111111111111111111111011111011110111211021201112012212b22000201221111111111111111111111111011111010010111110100111
2202210002122202020021110111011101111111111001101001111111011110111111110111110112010011222111010210b22122011211110111111110101111111111111011101100111011110110
2222221102122212121111221111100111111111111111111111111101111110111111111110100010112222100210012002b01122201111111111110111111111111111101110101111111001100111
1222200112122122101110222111110111111111111111111101110110111011110111101111110101211021220112022122ababbbaaaabaaaaaaaaaaaaaaaaaaaaaaaaaaaaaaaaaaaaaaaaaaaaaaaaa
2212200222202222020201121111111011111011111111101111101111111111100111111011011112212100121202100212211102221121111111001111111111111101011101101111111111011111
2222022201201001222200201111111111111111011111011111001111101111011011011101111111211211001122120201021001111111111111011111110111111110111101000111111111011111
2121020210210100022021112111111011011011111111110110111111011101111011111101001111222102212001211112210112122100111010111111100101111011110111110101011111111101
0220112210212221210020022111011011111111100111011111111111111111111011111110001010110120012121111101202011111021111111111111110011111101110101101111111111111110
2200212222222222222000111111111110111111111111011111100111110101101100011111110112021220210012000220212210211111111111111111111111101111111011110011011111101111
0212200221222122201222210111101111011111111101110111111110111001111111111111111112120120122100211212022221210221111110111110101111110111111111110111111111111111
1202222222202212212111222101111111111111101111111111101111011111111111111110110112100101112112112120121022212220110011101111111100011101111111111011111111111010
2202221212202012221110112111111111111111111111111001101111111101110111111110110111002210212201101101122022122011100011111111110111111110110110110101110011011101
2120220021220122122211012111101111111111111101111111011111101111101011111101111110211121122102212101121212202100111011111111111111101111111011111100111101101111
0222201122222221221022221111101111111111111011001111011111111011101101111101101111122221212122220102202100122221110101111111001101111111101100111101000111111011
2222211021221122021121021111110111100000111001101111101110011111111111011101111010211122122002120202220220022121111101111111110111111110111111101100111111101010
2202002021200201012101212111111111011111101111111111101101111101111010111111101112201001221200202121021102211120001111111011111110110110100101011101100001001011
2102212222202222000210221111111011110111111101011111111111111111111001111111110111211112120221111102212211201201111111111111111011111101111111111111111111110100
1220220212121222221221110011110101100011110111111111111101101110011111111111011112222102122020012011220211212121110101101111111111100111111111100111011111111101
1121100220202222222020120111111111111110111001111110011111111100011111111111101110200112111001021222222112000211111111001101011110111111011111111100111111110111
1222120122202222112121220110111000001101111111011111110111011111111011111111101112210202211202012121102011111220111101111111110001101111111101111111010101111111
2121201210122201111011100111010111111111011111011111110010111111111111111111101112111201221122202221221222002121212011011221112222111111010101011111111011111110
2022000222120111211111002211110020122221111222202111111011011111110111010111111110122011202212221111021011012122112221110211212010010111110011011111111011111100
1110110111101111111111111122201110110122111211222100111111001111111111111100111100121111222122111221222220222122122201021201101112211111001011111111011110111111
1111111111111111101102211020121022111101210210111111110111111001110110110111101112212112220210221112021012210121220112200122021220111110110111000011111111111111
1110111111101111101221021221012010110002010220110010110111001110111001111111110012012201012122122122111122202101011112111202002111001001111110110011011011110111
1011111010100111111112011210110122212102112102110111011001110111111100111111111100212001210211211012120010221212212022220011122121201011111111011111101101110111
1101111010110111101201111011012121002122212200101110111111011111111010011110011110122101101021212020222222022120222021202222101112210101111110101011111111101011
1111110011111111111201110121122220112202212122221111110110111011110111101111111112221020212211102211122201022220211212202212122121101111011101111111011111101111
1111011111011101111212101012121210102110121102222111011010111100111101110111111112122212020122222210221221222210112021122110221012011111111001010111001111010011
1111001110111010010221121222210002012212012121202010100111111111111101110111101111111111111011110011122121211211220101221222211222111111111111111011111101111111
1111111111111111111221001210111110211012012212221101111011111111111101111011111111110101011111111110112111111210111212012101201221201111111111110111111111011111
1111111010011110110201011211101221101212112010202111110011011101111111100001001111010111111111011111122001012210210002221221220212211110111101110010111110111011
1111111111011111111110012120221120121101121211010111111011111011111111101011111111101111111111010111112221121110021110122212111221011111111111110110011111111111
1111011111111101101120110211210020020220112201121111010100111100011111101111111012220200021101202122212022101220021221112222020112211010011111111111111111011111
0101111111111011110222111220222102221210021222020111011111111110100111010111111101222202211101222220222222212221112102121122010111211101111011111111011011111101
1111101011001111111211202202101202101221121101212111011111010101111110110111111110110222220111102212222210122021112011222120122111200011011111111111111110111111
1111111100111111111011221101121212111122122202210111100111111111010111011110111111012101212212001201222222202001111222202212212212101111111111101101111111101001
1111111111111111011111122111110222111220212120222001111011101111101111011111111011012222111122220201122222112002222222010120201201211111011111101111101110111111
0100101111111111111211222011020001221111221111002111101111011111111110111111101101121200112212212101222222002221221101222021120211110111101101111111111101111111
1111011001110111111012122212101021011121022201110111011111111111011001011111111112111100201212211222010110222201100212022122012011011100101101110111111111111111
1111111111110101011020110120212211212111021220212101111111111101111111110111100110012222202122220201220122202122220121220211220011211101111111101111111111111111
1111100111101111101222222222212112212011102221111101011111111111111111101111111111121212110102012021222200212220121010121221211112111011011111111111111110101111
1111111111001111011222212110011220121112202012110111110111101011011101110110111111210102022002020202100222120112111020110221110122111011111111010111111111110111
1101111111101001111011011012201100212011201212211111011111110111101111111111111112112222021220120211121220221222212111222121121002111111101011111111111101110100
0111111110111111111122120201121212111121122111222011111110111100001111111011111110210012011222121201000210221220101022122111202112211111111011110110111101111111
0010110111111011111122002221111201211212111112110110111111010111100111111111110110211222200100210222212220222201202222110111022221211101111011101111111111000101
aaaaaaaaaaaaaaaaaaabaaaaabbbabbabbbbbbbbabbabbbbaaaaaaaaaaaaaaaaaaaaaaaaaaaaaaaaabbaaaaaababaababaabbbbbbbbbbabbabaabbaabbbaabbaaaaaaaaaaaaaaaaaaaaaaaaaaaaaaaaa
1111111111111111111122222121001212211011022222111110111111111101101101111110111112210110222222110211222122112222110201221221212221200111101110111010010111111111
0011111101100101001222102101100210222102120121111111111011111001111111111111111010121221221201122112021220022222220001211122112000210111100111010101111111111110
1101011111111011011102122222211010200122121202202110111110110010011110110011111112121112121220120202100222122012120212211120120222111000111101111111111111111011
1101111111110111101120001000012212120022110010221011111111111110111110101011111112101122202221100112101012211211111111111111111000111111011111111111101110110111
0011111000111111010101111111101111111110111110101101101110011111111001110011011102211211101111112111210022021121110101110111111111011111001111101111110110011110
1111111101011111111111111111111111110111011011111110110101110111011111101111111112012221002002111111022111212221101111101011111111111111111110111110111111111111
0010101111111111110111110111001101111110111001111101011111111111111101111111011110010121200001022221222100212021101111111111110111001111101111110111111111111111
1111111111110111011111111101110111111111000110111101110110101011110111100111110112111221221102202022011202221211101011111111111101111111011110111101000101111111
1111111111111111111011110111111111111111101111010011010111110111111011100101111112121001012221220211202110021120101111111110101111101101111111111011011111111111
1111101011011110111011111101011011111011011111111111111111110101011111110111111010102120210002111112110122210111101111111111111110111101111101111111111110110111
1111111011111111110110011011111111111111111000111111101011110001011001111111111112222222012021122122011111212101111111111111111111111111100011111110011111011111
1111111110111111011110011011111001111111101111110111111111111111110111011101111112010122200112112012222211212000110011101111100111111100111111111101111111111011
1111100111111101111101111011111100111111111111101011111111001111111011111011011102112221101111021122221201112111110011111110110110110111111011111101011011110010
1011110111111111111001111101101101100101101111111111111110111001111011111110111012221122112200102201021211122201011111010011111111111111110011111011101010111101
1111101111111111111101111101011111101110111111111111101111111110111001111011011012121121211220001002201021002201110111110001101011111111011110101110111011010110
0111111111111111110011101010111111000011111100101110111111111111111111110000110101101211022002212111022221112011111101101111011111111111111011101110111111111110
1111011111011111111110100110011011111101011111011011111111010111111111111111101101111111011111111111101110110111111110111110111011111111011111111111111011111111
aaaaaaaaaaaaaaaaaaaaaaaaaaaaaaaaaaaaaaaaaaaaaaaaaaaaaaaaaaaaaaaaaaaaaaaaaaaaaaaaaaaaaaaaaaaaaaaaaaaaaaaaaaaaaaaaaaaaaaaaaaaaaaaaaaaaaaaaaaaaaaaaaaaaaaaaaaaaaaaa
111111110111111100100111111110111111111101111111111111111111011111111110111101110111011101111101111111011111111011111111111111101011110111110100110110101011101a
1011111111111111110111110101110111111111111101010101100011111111101111100111111100011111101110110110110111110111011111111111011111111101111110111111101111101111
1111111111101110101111111111111111111111110111111101111001101110011111101111111110111111111011110101111111111111110111111111111111111111101111001111111011111011
1111111111111111111111111111101111111111110011111101111000111110110111011111111100111111110111111111101101111001111111111101111111011111111011111101110011100011
1111101111111011101111111111110011111111111111111011111111111011111110111111111010111111111011101011111101111011101111011001111011111011101111011101111101111111
1011001111111111011111101011110011100111110110111111001011111111111011111111011111101111101111110111011111100111111110111111111111111101111110100011011101111111
