(116,91)
(8,61)
(40,91)
(31,146)
(24,117)
(44,88)
(29,125)
(39,18)
(27,116)
(110,17)
110111111111111111111111111101100110011111111111111101111111111111011aa111111110101010a1111111100100011111111100110111111001110111111001111111111111a11110111111
011111011011111010111111111011111111110111011111101100011101111101110a0111101111111111a0011110110111111111111111111001101011110001111111111101111011a11101001111
111101110101110110110011011101111001111011111111011101101111111111111a1111011110111011a0111111111111111111101111011111011111111110001111111111111110a11111101111
101101111111111111101111110111111101110111101111011010011010010111111a1111111011111111a1101111111111111111111111100000111101111101111111101011111111a11101111101
110001011110111100011110111111111111111110111111111111110110110111100a1111001101110110a1110101110011111011111110110111010110110011111111101110111001a11110111111
110111111001111011111111011110011101101110001110001010110111101010011a1110111111111111a1101101111111101011111111111101111111111011111101111011111111a01101111111
011111111110010010111111011111010101111101111001111011111111111110111a1110111101111110a1101010111111110011110011110001111111101101111010101111101111a11111111111
111111011011111111111111000111111111110111001101111111011111111111111a1010111011111110a1111010101111101111111111111111111100111110111110011011111111a11111111111
101110011111111110101111101100001111111111010111011111111111111101111a0011111101111111a1111101111110111111011111111010111111111111111111111111111011a11111011110
111110111101111110111111111111110111111111111111111110111110101111111a1111011111111101a1011011001001111002220221212012010022002112101111111111110111a10110111111
011011111110110111011011110111111111011110011101111111111111101111100a1011111111111101a1111101111110112012111221121220222101110202121111101111101111a11110111111
111111111101111011101010111110101101010101010111011111110111110111111a1011110110111110a1101111101111011021200112212222001112001110201111111111111111a11111111111
110111111111111010111111110111101111110101111101111011111111101111101a1110111111111101a1111111111011121221022111202221022110221211121111001111101111a11010111111
001110111111101111111111110011111110111010111111111011001111011110111a1111111111111111a0011111111001112210022222222201121210202202211011111011110111a11011111111
111111111110111110111001111001111010101111111111110111111111001111111a1101111011111011a1110111111001122120122222222222222222000021221221202111101111a10110110011
111111110111101101011111111011110111111110111111111111110111101011111a1111110111010010a1111111110010010122120022222022022221220221212210101111101010a11111110101
111111110011111011011100111001011000111011111011111111101010111111110a1111111011111011a0111111111111112202221222222021221122222222112022021202210111b11121121200
011111110110111111001111101111011011111101111111001110100010111011111a1011110011101111a0111101111111121020002222111210222222002221222210022120012022b12211122121
111011111101111001111101111001011111111111101011011111111100100111011a0111111111111101a1101101110111020012002120222222102200202222221212212110202211a21120211020
111111111111111111111111111111111101111110111111010111111111111111110a1111111111100001a1110101111111102212221122202201001222221000221222220222110212a22121121101
111111111010111111111011011100111111111111111110111111111101111011111a1011111110011111a1111011110111111220221220222202211012202022212022021220200010b21211121210
011111101111101110111001111111111111111111111100011111110111111101111a1110011011111101a1110110111111112220221222222220020202222210222220221212112222a02212001120
011101111110111111111110111111111111110001010111111011101100111011111a1111111111011101a1110111111100121221022021222222100211000220022021221212101111a02120122221
111001111111111110111111101011100110111110101011011111110011110111101a1110101111011101a1111011101011002112211020022122022202012202222122122201220211b21110010011
111212101220212200022121111002202011101111111111010111111111011111111a1101111111111011a1101011111111120122120222222202002022221222201112021211121011b22101122121
111211211212100111121121212210110101111101001111110111111011111111111a1111012222211012b2221221020222212200222120222222212221222012222212220122211212a22222121211
111022122021002212221202102221121000111011111111111111111110111111111a0101101201122202b0122012010101120222021122222202220201220010202222212212110102b21111221212
111011212120212202121111120021000111000111100101111111110101110111111a1101110221200210a1011221101220022220020222122222222020222210200122002202121011b22222221110
101100222002212221121010210121112101110111001111101101011110111111111a1101112112002212b2222022121221220222022122222020000222221121222022222212120221a22111221011
111100102220112012021112122210210110011111111101111111111001111000101a1111102112220222b2200122222110100202222102222220021022221020222222222101122112a20122022201
111110022011011212111121102111210111111111110011010111111111110111111a0101222201102222b1122222222222220222022020222220222020221212222002222211121122a12021222121
111221211212121221110221111221210011100111111011110111110111111000111a0102111221222212b2002022222222122222120200220222202222222222222220220202122022b22120121211
111112012121221222002220112202121011101110101111101110111101110111111a0012212222222022b2200012122220122022222222222220221222222202021012021222210211a11112221020
100011122222111120111021102012011011110100110101111111011011010001111a0112200220212222b2200222022222222222201222222222222222012010200220102122100112a11102202022
101202222112212220211112121210122011111101111101111111110010111010111a1111222022222102b1220212222112222122212122021022222021220201222022211100220212a02222212112
111220121210101211221211110212220111111011111111111111110111010111111a1101112011221122b1222122202212222022212222202122220001222222110212221121112221b22012211212
111222202110110110220012110212122111111111111101111011011110110111110a1112221122222211b1002222102210222220111021202012220022222222222122001120122220a02211112120
101222122212121102210211202220210011111110111101110111111010111111111a0112122102222022b1200212222120202222012121202222120220222222222221221021221112b12111100112
010212102202112222021102102001000100111111110101101011110110111111111a1111112022022212b2220201122222202222212102202202022201022202200122011221012111a22212210000
011222212201110012012222212101012101110001111111100111111110111111100a1001121122102122a2112200201221222222012221102001102012220222211121222002011022a10121011210
011120110201221011022210111222212111001111110111101111110111110110011a1112122220222122b0010222122222122111021201211001022211220021022212222202221221a00022221112
101111211221211100220122012221111001110110101011111101111101011101110a1112211001220022b2220222001120022222200122202011220022222222212220222200121212b21001211010
100112120201221010010211010222120111110111111011111111111111111110110a0110211222121221a2022202202222012111111121111222002102212111022221012211121222b12122121112
111011221120111122212222002222221011111111111111110111111111110011111a1112202122022212b2222221222211222112101121222121011021121121120220020012211222b10201111201
111120120212121112021210101001120100111111111001110101101011111111110a0010112202202022b2222222220222220111110101111111111101101011102102110102212121b12101201120
111011012121221210221021001211020111011111111000111111101110001111010a1112010222221222b2212221201222222200100000011000111101110111120220102101021122b21122002102
010220022210112110110021212112120101110001111111111101111110110011111a1011122021002222b2122201220122201022111111111101111111111110111111111111110110a11111111111
101012122111112220220110100010120111111011111111111111111011111111101a1112202210221020b1022222221220221200111111011011010101110111101101111111111100a11011101101
000121111002112112002201000102011110111111111111001011111011111111111a1102222220220112b1122111200222002212111111011011111100111111101111110111110110a11111011011
111211100221022111011220201122121010111111111111111011111110111110101a0110220102221201a0221202120120011122011111011111101111111100001110111100110111a00111011111
101021212102112222021111121101120011110000111111111111011011111111111a1110100202212221a2220222222222010122111111010111000111011111111111111101011111a01110101110
110010100220102210221112200120121111101111111111111111111111101011111a1112212022000100a2122201220002222121111111110111111111010110011111101011010011a11111101101
111121212112111121212202112122212101111011111111111111111111101111101a1110111102220022b2112022212222222000111110111111101111111111101100111111110101a11110110111
111101121221110021001222202112211111111100111111111011111101111111111a1111022212121212b2221122120220221101111011110110111010011111111011111011111011a10110111111
011111101011011111111111110111101111111110011111101111111111111001111a1111102202222221a2102202222220202202111011111111111110111011101011111010111111a11111110011
110111111110111010111111011111110111001101101110110000011110111110101a1112202221222122b1210122121121110011111010111111111111111101110111101111111101a01111110010
111011111111111011111101110111111111111111110110000101110111100011010a0101212221120111b2220102212120112111111110110011111111111100110111101111111111a01111111111
101111101011110111111010111111111111010000111110111011111011111110111a1101222220212111a2200101022210120110111110101011111111011110111111011101111111a00110001101
111111111101111110011111111111111010111100110110111111111111011110110a1112020022102211a2121120212122220111111111101111111011110111111111111110001111a11111101111
111111111111110101101111111111101111011111111111111110111111011111111a0110111110111110aaaaaaaaaaaaaaaaaaaaaaaaaaaaaaaaaaaaaaaaa011111111111111111111a01111110101
111011001101011100111101011011111111110111101111111110010111111111100a11011101000111110111111111111110111110110111111001111111a011001110111111100111a11110011111
aaaaaaaaaaaaaaaaaaaaaaaaaaaaaaaaaaaaaaaaaaaaaaaaaaaaaaaaaaaa110011111a01011111101001111111111010111111110011010101111101011101a111111011111111111101a11111010111
10111111101110111111100111111111101111111111111111111111110a110111111a11100111111100111111111111111001110110111111110111111111a111111111111101110111a11111111111
11110111111111100011111011111111111110111111111111111001111a111110111a11010111111111111111111101111111111111101101101111111111a111011111111101100111a01101111001
11010111111111111010111111111111111111111111101011111101111a101011111a10111001111010011111111001110111111110111111110111111111a101111111110011111111a11111111110
10111111111111110111111100111111111111111111101111111111011a011111111a11111011101111111011110100110011001111111011110111011101a001111111111110111111a01111111111
00001111101111101011111111101111111111101011111111110111111a111111110a11101101111111101111110111111110111111111110110111110111a101101111101110111111a11111111111
10111101101110111110111101111110111111110111011110111111011a111101111a01010111011111110111111111011111110111110111111110111101a111110010111110111111a11010011111
11110111101111110101111111110110011111111101111111110111110a110011101a11111111011100011111111001110111111111100111111111111101a110010111110111101111a11111110011
11111111111111101101111101011101111110111111111101101111111a111111111a00011111011111101111011111111101111110111000111111101111a111111111110111111111a11011111000
00111111111110111111111011111101111100111111111011111111111a111111111a11111111111010011000111111111111111111010111111111111110a111110111110011111110a11101011111
11010111111011011011110111110111111011010111101110110111111a111011111a11010111111110110111111101110011111111101110111101010111a111111010111111011100a10110110111
01111111111111011111111111111111110111111111011111010111011a111101111a11110011011111111111111110111111110111101111111111011111a111111001111011100111a11111110111
10110111110111111111110100111111111101111111100101011111111a011111110a11101011110111101111111111111111110111010111111101111111a101101111110111011011a11101111111
11111110111111111111111111111111111011101111101111111011111a011110100a10001111110111011111001101110111101111111111111011111111a111110001110110110111a01101110101
11011111011010011111111111100110111111110111111110110111111a011111101a11011111110111111101101011111111110101110001111111111111a111110111110110111110a11111101001
01100011110100100111111111111110100111111101001111111111111a101100111a11111010111101110111101111111111010101111111111111110111a011110111000011111110a11111111011
11110111110101111111010001100101111111111111111111111111101a011111111a11110000101111111110111111111111011100111111000110011110a111010111111111111111a11111111010
11111111101111111111111111011111011101110101011111111000111a111001111a11111001001111111011111111111111111101101111111011111011a111110111111010100110a11111011111
01101110111101111110111111011111111111111111101111111111010a111111111a11011111111001111111001111011101110101111011111111111111a111111110110111101111a11110011110
11111111110111111111111111111101101011001101111110111111111a101111111a01111101011111011111111110111110110010010101100111101101a111100111111001011111a11100111100
11111111111111111111111110110110111111111111111101101111111a101101111a11111010011111100111111111101011111111111111111111110111a111111111110110011111a01111111100
10111111011111110111100110100111111111111011111101111111111a100101111a11111101111001111111111001101111110101111110011111111111a101111010111011111101a11111111101
10100010111111111111110111111011111111111111111111111111110a111101111a11111111111111111111111111111111101101111010111101111111a110101111110111111111a11111011011
11111101110111101111011110011111111111111111111111101101110a001111101a11111111111111111111010111111111111111111111000111111001a111101011111110110111a11111111111
11010111111101111111111111111111101110110011100110011010111a110001111a11111111011111011111111111111111101001111110010111101111a011101110110111111011a11011101111
11111111100101111011100101111111111010111111110100111111100a111011111a11111011101111111111001111111111101111110001111110111111a101111111011111101111a11111101011
10111111111111011011101111011011110111111101111110011111101a111111111a11111000111111101010111110111110111111111011111111111111a101011010111111011111a10111111111
11111111011011100011111110110111011111111111111111111011111a111110011a11111111111111111111111111110111111011111110101011110111a111111011110011011011a11111110110
11011111011111110101110111111111111111110111011101111101011a111101100a11111111111111001111110100101111111110111011111110111111a111001101011111110101a11111111111
11111011110111111111100111111011101111001111111101111101011a000111111a11101101101111111111111010101110110111101111111111110011a111111111111111111111a11111010111
11111101101111101111111011011111111111011111111110101111111a011111111a11111111111111101110011111111111010111011111111111101111a101111111110111111111a11010110011
11111110111111111111111111111101000111111111111111011110111a101101111a10010011100110111111101110111111111011111111111011100111a101111111110111111011a11111111110
11111011111111111111111111110111111111101111100110111110111a111101111a11111101111111100111111011101111111111101111111111000111a111111111111111111101a01111110110
11111111100111111110111110111111011100111110111011111111111a011111111a11111111111011111100111111111111111110111011110111110111a111111111010111111111a11111111110
11201022002010121021102012001022111111000111101111101111110a111101111a11100100110111101111110111111111101111111100111110110110a111011111011111111111a11111111001
11101121212111102101022122120211111110111101100111111110111a111111101a11101111001011101010111101110111110110111111111111111111a111110111101111011111a11111101111
11202212220111211211111102201202111111111001011011111111101a110111100a11110111111111111111111111101101111111011111110111111001a111011110001111010011a11111111111
11121121121020221112120222002112010111010111111101111101111a101011101a11111111101110111111110100111110111111111111111111101011a110111111011111001010a00111111001
11220101222221221212122002020221111110111111111100110111111a111111111a11111111011111000111111101111101111111111111111111111011a111110111101111111101a01111111111
11111222101211211212221202101211011100101111111111101111111a001111111a11110001111110010111010101111011011110111100111011011111a001101110101111111111a01111111111
11112202122102120021221222201122011011111111111110111110100a101111111a11111001111111110011111111111101101111011111010101111111a101111110111101111111a11011110011
01120121220120211121212201021110111110111001111011110111100a111110111a01111101110111110110110010110011101101111111111101101110a111110011101111111101a10110010001
11201112001201021021212122221220111110111111110111110101101a111111111a11110101111111000001011111111111111111110111111111111011a111111111001111111111a11010111111
11112212021221010012120200101102101111101110111110101111111a111111110a11100101111100111111011101101101111111110111101111101111a111111110110110110101a11111111111
10020102122202211110102211210012111111111110011111111111110a110111111a11101111101111111110111111111110111101110011100011111111a111111111111110110111a11001110111
11021222122221211211212112210122111110101111110111101101111a111110110a10111111011110110011111111111010111010011101101101111101a111111111011111110011a11101101101
11211110020121121021212202200221111010111111111101111111111a111110110a11101111111011111011111111111111111111011110111111111111a011111011111101011111a10111110111
00112200221122121210212211122122111111111110001110111111111a011111111a11101110111111011101011110010111111011110111111111111111a111111111011111111010a11111100111
11110222101021122122101221212211110011111011111111111111111a111110111a00110101101111011111101011111101111111011110110111111111a111111010001111111101a11111111011
00111011212201111222110111201221111111111111011111100110111a111111111a11111110110110111011111011111001111111011110101101101110a111111001111011101111a01010111101
01012222221122020222101211210101111111111111100111111010110a111111111a11101111111111011111111111111111111111111111111110011111a110111111110011111111a11110011110
10212121112121011210022221211212111111111011110111101111111a111111100a11111110111111111010111110111111011111111110111011111111a001101110011011111011a10011111111
00210012100212222010112221121101010101101111111101110111111a111111011a11101111011101111111011111111100111011101111110111111101a111111111111111110011a11101110011
01200220002212001112211211201220111101011100101110011110111a101111001a11111100111111111111111111011111011000011111111111110010a111111011101111111111a11111101111
11102120220122122212112211212220110011111110010001011011011a111111110a11101000000111111011111111011111100101110101011101111111a111111111111010111111a11111011111
11010020002212112122201211010120110110111110111101111011110a101111111a11011111111110111011111111111101011011101101101111011111a111111111001111111111a11111011111
01122121212022100001200211022112111111110111011111101110101a111111010a11011111111110100011111111011101011111111101111111111011a111101111110111011110a11011101001
11111020221212222110112211211221011111111111110101111111101a000110111a11010111011000011011100111101011111111111111011110101011a111111111111111111001a10011111011
11112202221122212012111211121110111111111111111111110110100a111111111a11111111111110011110111111111111110101111110111111111010a111111001100111110111aa1110111110
