(88,0)
(117,151)
(78,24)
(21,112)
(2,3)
(73,127)
(3,100)
(63,4)
(112,143)
(64,57)
0112000122211b22210111111101110111010111110111111111111a11111111101011011100111000011122021102110221211121022212122101101a01111111110011111100011111111111111011
2102211121222a01011100011011011100110111110111011110011a10111111111111111110111001111012110100101111202100220222212111111a11111111111101011111111111111001110011
1112121221111a00221100111111111101111111111111110011111a11011111111111011111111111011221120122112112122221222022222111011a11010111111011011111111111011111111011
2200021212212a22121101111110101111100110010100110100111a10110111110011101111111011101202220110201111120221210011212111111a11000110111111011011111111101111100111
1121101112221a12120111111111111111101011111000111111110a11111011111101111011111011110100211212112001212211222102212111101a11001011011111111011111111110111110111
1212121022210a11111011101111101111011111111110111010111a11111101111111111001101111011201201120120222101122221221111111111a10110111111110111111011111111111011101
0221011001010b01221110000111111111001111111101111111001a10111111111101101101111101011211220212211222220222222202221122220b12202111111101011101111111111101111111
1121222120112b11121110011111111111101111011111111110111a01111111111110010111101111011202221210112012222021022122212012112a21202110111111011111111111111110011101
2011021101121b10121011111111111111111111011111111011110a10111101010111101001111110101112221211101112212002212222222120122b12000111100011111111111010101111111111
2220210211122b12121001010100111111110111101101011101110a11111111111110111011111001111110110222020222222122222222022212112a10111111110111111110111111111111111101
0212111222022a20111001011110110111011111110111111111111a11011011101111111111111110110011111212210220202220020212022010111a12121111111011111111100011011101111111
2112022111011b02020111111111010101010110100110111001011a01111111010011111101111110110101121210101202021022010222202222111a11012111111110111111010111110001111111
0020102220211a01200111110111111111111011110111111111111a11111111101111111101110101111012122201220022202222221020202111211a21220111111111110101110111111111001110
2020120202121a10201111111011111010110101101100001111111a01111111111111011111101111111022201012020112122220222022121120212a11211101111111111110111100111111011111
1121212101221b12120111111111001011111111011111111111011a10110111101011111111111111001020122012201121112222222212221222122b21101111111011111011001011010101101111
1220211012221b12201111111111011111110111110110101101111a11110110011111111011111111011012211022221121221012221211122212222a12220111110110111111111001111111101101
2101001120221a11221010000011111111100011111111101111011a11101101001110101111111110110211222220212122122220112222202212222b12212011110111111101011111011110110110
0110111111111a11011110111111111111111111100110111111111a10111111111100111100110111111221121122101110221202222221020100222a21120010111110111111111101101010111011
1110111111111a11100111111111010101011110011111111111110a11101111110101110111101110111110110110111102202222121101111211211a02120100011111111010111111111111011011
1111111111111a111110111111111111111aaaaaaaaaaaaaaaaaaaaa01101011101101111110011101101111111111111212221221022211101022112b22221011110111111111111111101111110110
1110111101111a110111101111111111111a1111111111111110010111011111101110111101111010101101011001111100112011012122022211221a11111111111110111111001111111111111011
1101011111101a111111101111101111110a1111111111111110111011111111101111111110111111111111111010100211122112002122210212002a00200110111100011111111111111111111111
1111110111101a111111111111110111111a1010111111111011111011111101110110101111111011111111101111111202012002220220211002212b11121111111111111111111111111011011111
0100111111110a111111011101111111111a1111111111111111110011111111110110101111111111001111111110111211120020201022121200211b12111111101111110110001001111110111111
1111111101011a111111111101011111110a1111110110111011110101111011111011101111101111111010111111111212222122210220002211011b12020011110011111011111111000110111111
1111111111101a111011110111111111110a1111011111111111010110101111110001111101011111010110111111111121212201222212102112002b22202101010101111111111001111111111111
0101110111011a111011111111111111101a0111110011110111101111101111011111101111111110001111110111011012102122122122110211020a11212111110010111111111101111111111111
1110111111010a111100111101001110111a0010111111111111110111111111011101111100111010011101111011111022012121111221212220211b02102111111111111111011111111110111111
1111111111111a111001111110111100110a0111111011100111111111101111111111011110111111111111111011111212211212210112120112010a11001111111010111111100111011111100101
1111111110111a101001110111111111100a0111011101110111110001110111111111110011110010111011110101111211111011022002202012120a12111110111001110010110011011101011111
1111111101100a000111111111111011111a0001111011111111001111011111110111011110011111111010111111110111212111111220111211210a22122111111111111101001001111011111111
1111111111111a111110111111011010011a0110111111111111111110110111110011011110111111101111111111011021102200202122212222021a12122111111111101111111011100111101011
1111001000110a110111110111110011111a1000011111110011111111011110111110110111111101100110111111111202222100212222121211111a21222111110111011110011111101100101111
1110111100011a111111110110111110111a1111111111100111111010101100111011101011111100101101111010111022122112222122221211212b20220111111101110010110111101110111111
1111001111111a111111111011011110111a1111111101110111111111111111111110111100111110110110111111111222101122212121221112212b21211101101111111100100110111011011111
1100110010110a111111111111010101011a1111011111111011111101111111111111110111111111101111110111011122012120122022101112112b21211110111011111110111111111111111111
1001011011110a111110101100111111111a1111111110111100111111111111011111011101111011111101100111011011111011111111111111101a01111101011111010111011011111001111010
0111111111111a111111101101111101101a0111111111111111111111111101111010101110111111011111111110011111111011011111111110100a11111111011011110111011001111111011101
0101111011111a111001111111111101111a1011110110111111011111001111101011111111110101101101111111111111111111111111111111111a11111101011110100111111010111111011111
0111111100111a101111111111011101111a1111110110110000111101111100111111101111111001111110111111111111111001110101111101001a11011011111111111010110101011111111011
1111101001100a100111011110011111101a111111101111011111111111111111111110011110110111111aaaaaaaaaaaaaaaaaaaaa1111011100111a11110100111011101111010111111110110111
0110111111111a110111111011111110111a101111110101111010111010111001011111011111111101111a1111110111111111011a1001100011111a00011111111111111111101111111111101111
1111111110111a111111101111111111110a111111111111111111111111111101110111111101110111100a1101110001110110101a1111111111111a10010111111111011111111001111111111111
1001111101101a111110101111111111001a110111110101101111111110101111101111111111111011011a1111111111111111111a1010111011111a01110111100110111111010011111111111111
1111111111011a011110110111111111110a101111111110100111011111111011111111101111110111111a1111111111101101111a1111111111111a11011011101111111111111111110111001011
1110111111110a111111111011011111111a111111111111111111111111111011111111101101111101001a0101111110111111111a1011111111111a11100101111111110001111111110110110111
1001111100111a111101111101111110111a101110111111111010111101011111111101011011011111111a1110111001111111111a0011111011111a00111110101101011101100101111110111111
1110111101111a111001111101011111111a110111111110111111111110111111111111101111111100011a1110101111110011101a1101111101111a01011111111111111011111011110101110111
2102112211220b112111111110011111111a101011111111111001111111111110100101010111111110111a1111011111111111111a1110111011011a10110111011111111111111010111111111101
1201221220022b221011111101101010000a110111212111221011112000102110221102001011111111011a1111110011101111001a1111111011111a01011111111101011011111111101011111111
1020211102112a222220011011011110011a010111002121212000120112021222212022111111111101111a1111100111011110110a1010010111101a11111100011111111111011111110111111110
2221111121102a211021011111111011110a110011111111210122111212112122211101111100011111111a1011111111101110111a1011101111000a11111111111111101011110111110110111011
0210020121211a222211110010110011110a111110112000112022022112101021111222011001101111111a1111111111011110111a1111110010111a11011111010111011111111011111111111010
0202220211221b012221110111111111011a111111221202112111221102022121222111111001001110111a1111011111111110011a1110111011101a11111111111111110110001111111111101111
0201101122212a121120111111101111001a111110210210212211212201220021211222101111111111110a1111111111001111111a1011111101111a11001111111001101111011111110111101011
0201112110212a100101111111111111111a111011211120222112111111002121221012001111101111111a1111111101111110111a1110101111111a10011111111011111001011101110011111110
0112121001121b201221111111111111110a010111220212201222222001221210222121111111111111111a1111111110110111101a1110111111111a01110110010111111111111111111111111111
1021101001022b120211111010111111101a111111101222220021212211110120002001111011111111101a1111110111111111011a1111111100110a11111111101111111110010111111111111110
0111022212211b222021111001110111111a011101102112111211222122211111011121111011111110001a1101111100111111111a1111111100220a12110112211222110221110111111111101011
2001011010222a121221111010101101100a010111211201211221112220011211210021110111101111011a1111111101011111101a1111222021112a22210122221211021122001111110111111111
2012122111211b202120111011011111111a111111111222212212112211010120220110101111111111110a1100111111111111111a0111212022101b21212010111202220121111111101101101101
1222100102220a121211111101111101110a101110112111210111211122202122222022111111011111110a1101001110111111111a1000121210012a11220111012222212212111111111111001111
2121110112102b122021100110111111011a110111220122121120211101112111210122011101111111011a0011110110111111111a1111011221212a20112221021011001210011000111111110111
2120121120020a220222202012122211221b021101221210210112222111001201101120111111101101011a1010010101001101111a1001022111122b22112110021022222221011111101111111111
0121112112212b212202021102122012110b121111102212211222121102011010201221110111111100100a1111111111101111001a1110120101210a01122222110221220122110111101110001010
2221120212220b222021121222222111201a201101022212011211220112202121121212111111111001011a1110111011100101111a0111210221211a12021121122122210222011111011111111011
2102002002222b202111221021120111112a222110021012100222222101222110121102111111111111101a1110111101011110111a1101011111202a11111221212121111211000011111011111111
2211212220022b022221102101111101222b121110022212212212201210221010022201110111101111111a1111101111111011111a1111212021200a21111000101122220100101110111010101011
1122212102222b202002112112101122221a020111112221122211122222121101122221111101110111111a1011111111011111101a1110222101111b21110010002021022010110111111011010111
2112112012002a222010222121212112110a221111102112221011221212020122111102101111111010110a1101111111111101111a1110122100111b22020021111121222211111001010110110111
2112222202222b201200201111201110111a101101100222012112022122122120222012110100111011100a1111101111011111111a1101000112222b11120112212212112210011100101011110011
1011122120202b001220112011011121122b011111212212221001121210010220201020001111011110110a1111110101111101101a1110222112221b12211202221221112222111111110111001111
2012010112012b222222221021001111111a210111121220122020101201200122112110111110011110111a1011111111010111111a1111221202212a21202221102222211111111111111111111111
2220012112122a222211222111111010020a221101112121102221211202201222221222111111111111111a1111011111111101111a1111112120012a11012112212112012212111111101111111111
0101022100222b212001202101222221210b121111121022011122012112222022022221001111111101111a1101111111101111111a1111101212210b00211101121012121222011111111110011111
1122121122122a222200221122212022102b111111112101111211102222210001201110000111111011011a0111111111111111011a1111212112012a02120212111212002121110111111111011011
2202122201221b221221101022102211011b210111012121021100110022212122112021111111110011110a1111111101011111111a1111201211012b12202112122221022121011001101111111111
2101200210222b200221212121102100111b110111222120011111220211022011212222011111111110111a0111011011011111111a1111021101121b02011220120002210012111001111110001111
1111111112220b101222112201222212200b011111222122010212102102222122012102111101111111111a1110111001111110111a1111102212222b12220121020002122020011110111011111001
1110010112221a222120101101022212122a112010110011110111011110111111111110011111111011111a1111111011101111101a1111112221112a02121021000102011202111110111111011001
0111110112022b221001011112120121120b221101101111111011111111111111001111111110011111110a1111101111111111111a1111211212112b21121221111112022112111110010111101110
1111111112010b120111121020122210010a212011110011111110111011111111111110111101110101010a1111111111101111111a0111111122111a21212021211112110212111101111110101001
1111011110220b022101011222011010212b112100110111101101111111111111111011100111111101110a1111001011111111011a1111200012001b11122122100101112011111111111111111011
1011100012121b121121221221110121120b211110111111001011101110110101111111110111111111111a1011110111101110111a1110101220122b12121111211112021112101111011111011100
1111111002110b120220112111012011221a122111111101111111110101001100110101111101101101001a1111110111101011001a1111210222121a12101021212121221122010111011110111111
1011110011202b220121001221120110021b121111001111110011110101011011111111110110110111100a1111111111110111110a1110221221110a11122101211210122020011111110111011100
1111111011201b111212112201200011222b212011110101111101111110101111101111110111110110111a1101111101111101111a1111102011110a11211000111211012122111111100111011111
1011111002112b121100122222122012212a202101101111111111111111111111110111111011111111111a1011111111011111111a1111010120221a11120001220221211100111011111111101011
1101111111222a122222201221221222000b122111111111110111100000111110110101001111101110111a1111111111111111111a1101111111111a10111010111111101011011111111101111010
1111101002222b222011121102210112112a021001101110011101111001111111100111011111011111111a0101111111111101111a1111111011110a11011110110100011111011111111111101111
1101111112102b001112211212210122012a212111111011111101110111111010101111011011100111111a1111110110111111001a1111111011111a10111100011000111001101111111011011110
1111111110212a210202011120102022210a022111111111111111111111111111111111100111011111000a0111111011110111011a1111111110101a11111111110111110111110111111111110101
1111111102122b122210121112211100101a211111111100011111101111111011111110111111111101011a1111111111010011111a1111111111011a11101111101111101000101111111111111101
0011011111111a111111111011111111101a101111111100110110111010111011111100011111100111111a1111110101111111111a1111101001111a10111110111111111110101111101101101101
1111111011111a111101111111110100111a111111110101101011011111101100111101111111011110111a1111101110111111011a1111110110010a00111111111101111111111101111110101001
1111011110111a010011110111111111110a111110111111111111101111110111011110111101110111010a1101110000111010011a1110101111100a11111111101111011010111111111110111110
0111011110111a110110110111110111110a111111111111111101101110111110011111101110100111111a1111111111111110110a1011111111100a10111111011111111111111111111111111101
1111101111111a101111111111111010110a111011111110110111111111111111011000101011111111111a1011110111111111111a0111111101101a00010112221211201011211110111122210211
0110110110111a100111111111110111101a110110111111111111010111111101101111111111111011111a1101111011010101110a1110110110111a01111101111212222120111210221121112211
aaaaaaaaaaaaaa111111111101111111111a101111111111111111110110011111110111011001111111111a0011111110011101001a1110101011101a11111122022220221112111001111020201200
11111111111111111111111111111111110a111111101111111101111011111100110110101110111111110a0111111111111111111a1111010111111a10111120021212202022222111021111121111
11101011111001111111011110111110111a111110011111101111111101011111011101101111110110101a1111011011111111111a1111111111011a10110120102222211221211200221120022211
10101101011011101110111011111011111a111101111111110111111101111110110111110011111111011a1111111111110011110a1111111111001a11100101020021102222222212211102201201
11111111111010110011111111111110111a111111111110110101011001110111101111101111111110111a0111001111111101111a1101111110010a10111122121122222210011211111221102111
11111110101101011101010111111111110a100110011111101111111111101101101111111101011101010a1110111111101111110a1011101111111a11011010011121022221111222022010221211
11111111111011110111011111111111011a101011010101111110011111011111111001110111010011111a1111111110000111111a1111101111101a10110111102100211212102020202221101111
00111111111111111100111011100011111a111101101111111101101111110101111101111110111101111a1110000111101111011a1111111111111a01110121011000011211112022222211202111
01001011111101011011111111111010111a111111110111111111111110110011111110111101111101100a1101111111111111011a1111011111111a11111112121012221101220122001202200101
11111111111011111111110111101110101a000111111111110111110011111111111100011110111100011a1110110111111111111a1101101011001a11101112222202212222102021202211022101
11111111001111111111011111111111110a110110110111111100111011111111110111111111111111111a1111111111111111001a1111101111111a11011111221111110211222222102111100110
11111111110111101111111110110111110a111100111111010101011011111111011111011001111111100a1111111111111011111a1101011111110a11011120221102222212121112212221111211
11111111111001111011101110101111110a110110111011111111111111111111111011111111001111100a1111111111111110111a1011111111111a01111012122012222101220122100122112110
11111001111111111101111111101111110a110111101111111110011111111111100111111110111101111a1111010110011111111a1011110110011a00101111122220202222222121101221222111
11110111110111110111111111111111111a111110111111110111111111100111010101001111110101111a0011010011111101111a0111111111101a11101101120121121121121221211122121101
10111100110101101111011111001111110a110101111101110111111111111111111111111111111111011a1011101111110111111a1101111111011a01111122111211212212122221221220220211
01110101111010111111011011111111111a110111001111111011111111110111010101111010111111111a0111111111111111111a1110111101110a11111111201020220122022200202221111211
11101111111101111001001111011111101a110111111101001110101111011111111111101111110111111a1111011111110111001a1111011111011a11010110121022111221112121221112221111
10110111110101111010111100111011111a101111110111111111111110110111101100110111001111011a1101110110101011111a1111011111110a11011011100102220021112220002221212010
11111101011110001111110101011011011a111101011111111001111111111110111011111011111111101a1011110101110110011a1110111111111a11111111121212221101221112112202220111
11111111010111111111111111111111101a110110101101111111111111111101110101111111111110010a1101101111111111011a1110101110111aa1111122101202221002200221112220011210
