(97,14)
(114,158)
(63,57)
(60,36)
(106,102)
(27,94)
(95,15)
(16,77)
(94,56)
(66,60)
1111001010110110111111111010011011111110001101111111111111100111111111111111111a1111110a111111011111001110111111111001111111101a11111010011111101111100111101111
1011011111111111010011111101111111111111101110111111111111011121022212000121222b2002201a001211111111111111010101101111111111101a11011111111111011011010111011111
1110111011111011110111011110000111011111111111010111111111110121221211011122122b2011112a112110111111111110111110111010111111111a11111010111111111111111100101111
1111111111111010110101011111111111100111111101111111111110111121112012012212021b1111211a112211100010111111110111101111101001101a01111110001101011110011101111000
1101011111111100110011010111011101111111110111111011111001111121201022121012122b2011202a101110111111111111011100110111111111111a11110111101011111111011011111011
1001011111101111111111110011111111111110111110011111110101110102211121001010120b0221222a002111110111111111111101101111011111110a10101111111011101111011011101011
0010101011110111111101111101111111011101101011111111110110110121220100112100120b1221001a101211111010111111111111110101111111011a00111110111101111110110111101111
1111101111100111100111011011100110111101111111111011111110111102202021011122121a1222102b121011111111001101111101110111111111111a11110110101111111110111011110111
1101101111111111111111001110111011101101111111111111111011111120102102022101010a0111110b021011011011011101110101101111101111111a11111110111011001111111111111111
1011001001110111111111010111111111111111111101011001111111101100221221101021001a2212120b220201011111111111111111111111000111111a11100110011111111111111010111011
1111111111101111101111111111111111111111101011111101110101101120012211111102220b1012212b220211101001110011111111100111111111111a11111111101110111110111101101101
1101111111111011111011111111111011110111011111101011111111111111101212222121120b2220202b101211110111101111011111111110111111101a10111110110111111101111101100111
1001111001011110111110111111111111111111011111111101110011110110010212221211022b2202221b202221111221121221222011011101111111110a11010110011101111101110111111110
1011100000110111111101110110010101111010011111011111111111110121222220212022120b2011022b212212020222102021220110011111110101111a11111111111111111101101111111011
1111011111110111111011011110100111101111100100110111101111111112121211100222102b2202121a012022220112110020002000011111111110111a00111111101111111111111111111111
1111111111111011111111111111111111111110101111111001001110111111121212212010112b2120022b022220211222202101012111101111111010110a01011111111111111111111111111111
1110111111111111111110111111110111110010111011101101110111111110120012012211011b2221212b222110011011202011201111110110111111110a11111011001011111111101111110111
1010101111101111110111111111111110111111110101101011001110111121122212202012101b2221122b221222111222221210021111101111111011001a11111111011110011011100111011110
1110101111111111111010111111010110010111110111111111111010110102120002112202022a2202202b202221101212112211221111111111101111111a11011111011111011101111111111111
1110111111111001110011011111011111111111111111111011111011110111201022102210220b0202002b212011121111001211211111100111011111111aaaaaaaaaaaaaaaaaaaaa111011101101
0000100111110111110101111111111111111100111111111010111111111121211011110121001b2202222b21220212120111112220110111110111101011101101111111101111111a111111001111
1100111111111111010011111111111011111111110111111101111011011112121220202120120a2212212a22121221212101000020201110111111100111110111111011011110111a111111101111
1001111111001111011111011111101111111111111011111111010010111011121111221212220b1122201a12020212212112112012001111111111111101111011001111110111110a111011111001
1111111010111011010101111111111110101100101011110111111110011121210211111111210b2020121b22221222112111202120111101110011111001101011111011001111111a111111101101
1111111111111110111110111101111110111110111110111011111111111112102201221222222b2221222a22122202211211120111011011111111111110111111111111011111011a111011111001
1111101111111101111111111111111110011111011111111110101111101102202110120102012b2202111b10210120022210122220201011111111011111111011011111110111111a111111101110
1111101110010110010111111011111001010111110111110111110100111122111120222202121b1122201b22220222021220101220111111111110111101100111111111111110111a011111101101
1111111111111111101111111011011011111011111111101110110001111021221012102111111b0021222b22111112211200112210210011111111111101111111011101111111101a110111111111
1111111101111111101101111111111101100110111111011101111111010121011202121012121b2122201b22221222220221120210111011111111110011111001111110011101110a111101101111
1111001101100110011111111111111010111101111111111111111111111121112122212222121b2022222a22221220111122111112211101111111101111110101011101100011110a111111111110
1110111101111011110111111011001111101111111111111111011111110002202120221211122b1222202a20222001110112021212111111101111111111010111111110111111111a010101111111
0111111111111110111111111110111100111001101111111111110011110101110010111110111b1112222a22202111220110222102110111111111011111111111101011111110111a011111100011
0101101111111111101011111111111101111011011111101111111111111001111111110011111a2121221a22022121221220122211010110111111111010111111111111111111111a111111110111
1111111111110101111011011111110001100111011110101111110111001111111111111111101a1002102b00210200012112111010211110011101011101111011111101010110110a011101101011
1111111111111111011110011010011111111111100111111011111101111111001011110111110a1120111b12112220102102112121211100111111111101111111111011111011010a111011011110
1011111101110010101111101111011011011110111101111111111001111101111110011111100b1211210a00211222110120102211211001111011011011101111011111111111110a111100111111
1110111111011111001110111111111011101101101111111111111110110111111100111100111b1222110a00112212102111110121211111100110001110011111111111110111011a111011111111
1111111110111111111101111111111111111110111111111111010111001111111111101100011b1201121b11221220021022212122001111011111111111111101111111101111011a011111010011
0111110111111110101111111111111110111011111111001101111111110101000101111111111b1021102a11120212211111012211110110111111011111111111111111011111111a111101101111
0111011110111110111aaaaaaaaaaaaaaaaaaaaaaaaaaaaaaaaaaaaaaaaaaaaaaaaaaaaaaaaaaaab0222222aabbbbababaaabbabababbaaaaaaaaaaaaaaaaaaaaaaaaaaaaaaaaaaaaaaa110111111111
0110011111101111100a01011111111111111111111111011100111110011111101110111111011022100202110221221201221211220111011101011110111011011010111011111011111111111111
1011111101011111111a11111101111001111101011111110111111011111111111111110111101001112220101201122211211112122111011111111101111011010111111110110111111111100011
1101111111111111111a11111001001101111111100101111111111111111111111111110111011011110110111011110001111011111111111111111101111111111111111010111110011111111010
1011101110111110111a11100100111100111111111111111011111111101111110111111110011111100111101111101111111111111111100111111101111111000011101110011111111111101011
1110101111110111011a11100111101011110111111110101110111101001111101111101101111111111111111110111111101111111111011111111011100100111001111111110111101111111111
1111111111101100011a11012121222221111212111212102111110111111011110111110111111111011111011111101111011010111111111110101111001111110101011100111111110111011111
1111111110111110111a12202220221211010112002120112120010011111110101110111111111011111101111101110011011111111011111111111011111011111111011101101110111101110011
1000111100101111101a11222202212112200112102122111120111011101011101111111011111101111010101011100111111111001101111111111010101111111111110100111111111101111111
1100111111101111111a12121211101122011122011222022221201121220110221221101110111111110111111011111111011111010111011111111011111111111111110111010111111111011111
1101110111111111010a12101122121011202020222222222222101122121021221210121111111111111001111011111111111101110111110010111111111111111111011111111111010111111011
1101011111111011111a12221201120212121221220211222202222002201121120211111111110010111111111111110111100111111111111001101111110111111011111001111101010100111111
0111111101110111111a10210122112021212112210202200222212220200221021022011021010011111111111101001111101111111111111010111110100111111100111111111101111111011111
1111111111111110111a11120210110022102211212221221221102222020212212222011000111111110011001010101101011101111111101111111101111111111101111110011111111111100111
0101110111101111111a01121112112122011212002211212222222222122020022102021101111011111110111001111111111111001111111101111111011110111110010001101111111111000011
1111101111111011111a10100222221112210010112200222122122022211121221020020121111110101111011001010111111101110010001101111111111100111111011111101011011111111111
1111011101111110110a10110212220002022100012020222020102221222221120012221021111111111111011011011111111111101111111011110111111011111111111111011111111111111010
0011101011111010111a10022022110121110101012222222221112222120222200102220221110011111111110111111011001111111011111111111111001111100111110010011111111111111110
1101111111111111111a10021011011021222201022202220222220221212022220022222101101011110111111101111101011101001111001101110111111110101111001101111111111111111101
1101111110001101111a10110112211011111121102212200022220222212202202220222110110111111111011111110010110101001011101011111111110111110111101111111011110001111111
aaaaaaaaaaaaaaaaaaaa12111110210211220212211222222220221202111122222222022221010101111011111101011101011101110111111111101111111101110101101111111111101111111111
aaaa01111010111111111022212022111102221101112222122000022222222212212200211111aaaaaaaaaaaaaaaaaaaaaaaaaaaaaaaaaaaaaaaaaaaaaaaaaaaaaaaaaaaaa110111110011110011010
111a10011111101111001002200221111201020212001222222001222201222122220222012011a11111011110111111111111111101110111011110101011111110010111a111111101011001110111
111a11111101111111100211222112021221021022222220222222202022010122022022121011a11111111111111101111111111111101011111111100101111011111111a111110101010110111111
111a01111111101110010121120020012121122211222020222122010221220002222222212111a01111011111101111111011111111111110110011111111111111111111a111111111101111111111
111a01101110111111111100211112222022121120102122222210221211202122022220002111a01010101110001110111111111111011011111111111111111011111101a101111110011011110111
111a11001101010111101201111221011201211121122220111122121221212022222120120111a11100111111110111110011111110101101011111110101101110111101a011111011110111110101
111a11111001111011001212202121011201102011222222022121022202220222102202220111a10111010000111110111011111111111110110111110111111111011101a111111001111111110111
111a01011111111111111102222112222022202221102002202121222221220211222102221111a01111010111101111110111101111111011011111101101001111101011a011111111011111111111
101a11100111111001111110022012100112221222100222101212011212122122110211120101a11010111011001111011110111111011110111110101111101111110111a011111111110111101111
111a11110111111110111112221110012202110111020200022220212112212220202222111111a10111101011111111111111011111111110111001111111101111001011a101111011111111111111
011a11111101011111111001111212021012211210102022022022220121202201220020022110a01111111111110111111111111110111101111110111111011111110111a011110011010111010101
111a01111011111111101221111011112121021122222120022120102222222221220202121110a01101111100100101111111011111111111111111111110111111111110a111101011110101111110
111a11111110111111111202222211121011122222222222202211221221112202122220201011a11110100111110110111011111111110111111011111111001011110011a111111111011011110111
111a10011100111001101112121122122102121222012022222022201122002122000222012111a01111010111110111011111110111111101110111101111111111111101a111110111111110101011
111a01111111111111111212002222121000102101222020222122022121202222120220210101a10011111111111111101010011111111110011111111111111110111011a111110011111111110100
110a10111111111111110111111111111111101111221222112120200221121110222222110011a11011111011101110111101111101111111111110011111111111111011a010110111111111111011
111a11101111011100111111111000111111110011212221110102022222020222000122102011a11111011111111111111011111010111111111111111011111101110110a101111111111110111110
100a10111110110011111101111100101111111111110220212102022022222222122022112101a11110111111011010101111111111111111111111111111111111100111a111111011111111110111
101a01111111101111111111111111111110111111111011121221012102021221021101021111a11101111111111110111111111010110111111111110111111111110111a111111111111111001101
111a01111111011111011111111111001110101100110222122212202022112222212221221110a11111010110111110010101011011111110111101010011111111111000a111110111111011111110
211aabaaaabaaabababaaabbbbbabaaaaaaaaaaaabaaabbbbbbbabbbababbbbb12222222222010a10111101011111111110111011111111101110101111111101001111111aaaaaaaaaaaaaaaaaaaaaa
012220211121000212021121122020110111110110212111210221112020121a22022111111111a111111101111111100100110111111001110101100111101011111111110111110110001101111111
110100220111222221201100101221011111111112010101101102121212112b22202111101101a101111100111111111111101111011101111110111111111111111111110011110110111101011111
121111211100210022222111221211111111111110202112220212122121122a12202110111100a110111110011111110111111111110101111111111111111110111111101011111101101111111110
222011111121211122101121222222011111110111102111122211101211220a10101121101101a111111101110011000010111110111111111101111111111101110111111111111011111111100011
112112220122022212002121010211111101100112112211002022221011221b01111220100011a011111110001111100111011111101101111011111111101101111011111111101010111110111111
201220102121011122120100102001111011100111010112111112210221020a21112111100001a111111111010111110111101111111111011111110111111111111111111011111011111011111011
121212211120012112222111211121101111111112121121212212221221001a22220111111101a011100111111111110111111011111111111101110101101010011101111110111111111101011111
110212210211221210220111012122001111111101120211120201212102121b21010211110111a111111111111110111111111110011111011111111111101001011010110111110111110111110010
020102222212111112221221122021101111111101022122011101020200211b02211111110111a111011000111111110110101010111101111111101011111111110110111011011111111111111111
122222111112211211202222200021111010111111201101122221112112111b11220211111011a101011111101111111111101111111111101011111111011101111111101111111111111110111111
021222112221201101220222201212011111101112022121211212210120111b21020121111111a111111110021211201111112121112221011221001110101101110111110011011111011111111111
011011110112122111111002010212111111111002221112211111012122211a21012121100111a111111112221101220210111220111120120101111101100111111011100011010110101111111111
111122221110111210222212221222111111011112110022221102121011001b21021221111111a111111112101112102012021021222121211000011111111111111111111101111111011101111111
200121210011102210202011110021111101111010121210220110021201212a22222211111111a111110112012102110110102012201211122101011111111111111111111101111111101011110111
122212221122111202220002202120111101110111111100011012201121002a12221201111110a111111112222222202121212002211122111021111110111110111111111111111101111111110111
122120001011211110122211201212111001010110100212221212022021112a22122211011111a111111112112211120221111221210101202221110111111111100111101110111110111011100111
122111112121121201222020212212111011101112220102220010221202221a11212200000101a111111111112202221222110211210112022110011111111011011011111101110110111001110011
122202001221012111201211122011111111101111222202212222111222220b21212201010111a011111011202101202121111100021200112011110001111011111011110111111111110111101110
021111202021211201000122221020111111111012201001221221021200111b11112011111110a110111111122221001222200021020111122121001101010111111111101111011110111111111111
011221101211221111011220110021111111011010200112102210222000212a01122121110101a111111112212220110022021111202002222111111111111111010111011111111111001111111111
012202021122121202111221011212111111111002221220120102111222220b12122001111110a011100102112111121211121010210111121121111111011110111111110111111101111110101111
021011120111111220211221122012110001111111201111122212211111001a02221121111011a111111111122201210112022110012111220210111111011011111111111111011111111110011110
012222221221121111201101222122111111111012120112112112121022200a21111221111100a011101110011102022201121122211221100121111101111111111111101111111111101101111011
221121120021220211110012011101101001111112220110122120110121122a11122211111111a111011110211020121202021021111221200011110011011011011111101110111010100111111111
211211211022111210222112211202111101110011200101222220211100210a21111121111101a110111112222111112220111202001212111221101001111111111111101011111111011111110001
201212221021200121022100201010111111111101222102222110111221120b22102001011110a110111110012211112101112112122210022120110111101111101101101100011111110011111111
102202221021020222110220221110111111111010202211122120122212122a00011011111101a100111111121012220122210221222122222221111111111011111101111100111011101111111111
012022121120022122111221212111111111111110211222201112212220122a12010201011111a111110111012012201112220222110121221211110111111111111101111111111111000011111111
022221221202011201210200212101111010111111101111111111111111110a11111111011011a111101102111200122001220122222110121211111110111101101111111111011111001111110111
101110111000100111111110111101111001111110111111111110111011111a01111111101111a111111112110011121121122012202021221111001111110111111101010111111101111111011111
110111111110111111111110110001011111011111100001111111101111110a11111111101111a111111010221220212021212122222211221111011111111110111111111000111110111101111101
111110111111011110111111111111111110111111111110111111010110111a11111101011010a111111112212222210211112222212121211011010111111111110111111111111111101011011011
111110111011111110110011111011111011111101011011111111101110100a00011100111111a111111001222011111021001211121212110111101101111110010111111111101111111011011111
111101111111111101101101111111111110110111110111101101111111110a10011101111111a111111111110211222112000112201021110011110111111101111101111011011100011111101111
111111111111111111111111111011111101111100111111110111111101111a11111111101101a111111112211221122002112111021122200121111111111110111111111110101011101111111111
101011111111111111111111111100101101101111111100111111011101101a11010101111111a111111112222200202010012020012201212210111101011011111111111111011101111111111111
111110111111001010001011111011110111111011101001101111111100111a11111011011110a010011111112211222101212122022222211111101110111111111110111100001111111111111111
101111001011110111111110111111111101111100101110111101110111011a01111011110111a111111111220022001120220202211001120210111110011111110101111111000111011011111011
111101111101101101101011010111011111110111011110101111101111111a11111011001111a110111110211111112121110022022212220221111111110111010111011111111111111110111111
