(109,3)
(4,155)
(24,122)
(77,44)
(55,155)
(82,134)
(111,116)
(83,71)
(57,147)
(52,6)
1111111110111111111111001001111100101111011011111101101110111111110001111111101111111111111011001111110011101111111011110111111101110111110111011011100111110101
1100111100011111111011111110101110111111111110000111001111110111100101111111111111111111101011011001111110111111101111101111111111110111010101101111001011111101
1111101111111110100101111110111111111101111111111111111111111100101111111001111111101010101101111111111111111011011110110111111101111111111111111111110110101111
11111011111111011111111111111110011111011010110011111111011111111011101111111111aaaaaaaaaaaaaaaaaaaaa111111111111111111101111111111111011111aaaaaaaaaaaaaaaaaaaa
10111111111100111111001111111101111101011111111011001110010101101111111110111111a0111111001001110111a010111111110111111111110110011101111111a1111111111010111100
11111111001110101111111010111101101111111101111110111110111111011111111111111001a1011111111111111111a101011111111101111011100111101111101111a1111111010110111111
10111110111011111111111110101110011011111111101111111101111111101011111110111010a1111111111100100111a111111110011101111111110111111110111111a0111110111110111111
10101111101111110110111011111110111111101110111111011111011111111100111111111110a1111011111101111111a111101111111111110111011111111111110101a1111111110111111110
11110111101111111001010101111011111110111111110011111111111111001111100111111111a1011101111101111111a111101111011111011011111101011111011010a1101111111011101111
11110101101101011011100111111101111111111111101111111111110110111111110111110111a1111111101111111111a011111211212111112210022021010121210111a0100011110111101011
11100111011111111111011000001111101111011101110111011001111110111111111110100111a1111110111111101011a111111211222021222211221211020201122111a0011111011111111101
11110111101011011001111111101111111111110111111101101011111111111111111111011111a0111110111100011111a110111222121121120221112101110110222110a1111111110111011111
10111111111110111111101111110111111111110111101111111011111101111101111111111111a1011111111010101111a011110212112101122011212021012211121110a1111111111110011111
11100111110111111111111101101010101111111111110111011011111010101111101111111101a1011111111111001011a111011012211112220202101221221220010111a1101111110010011111
01110111111110010111011101111111111011111110111110011011111011111111011111011101a1111111111111001101a110111012000222202112211212022002110101a0101100111111111010
11101111111111011111101111101111110111111111110111011111111111111100110111111110a0011100110111101111a111111102011220012120121122100121201111a1101101101100110111
11111111101110011111111110111111111010111101011111011100011110011011110110110101a1100100110111111110a111111221001220110222211221200201111111a1110111011101110111
11111101011111110111111100010101111110111111111101101101011111110111000011111001a1111110111101011011a111111200200011110212121102211112121111a1111111101111110111
10011111111001110111101111111111111011110011110111010111110101111111110101111101a0100111101110111111a011111021112120110122112122111212110111a1111111111111111111
00110100110101111111111111111011111111111011111111110101110111101101111100111111a0101111011110111111a111011111222101112212200112112221221111a1111100111111110111
11100111101111111111011011111111111101110110111111011111010010111001110111111111a1101011111111101111a111111022200200121010121011121122221111a0111111111101011111
11111110111111111011111111101111111111100111111110111111111011101111110111110111a1111111011111100111a011111012221211111210221122120212211111a1111110110111101011
11111111111111011111111111111111011110001110111011111010111111111110110111010111a1010111110100101111a111011112210202220011221121012011221010a1101011110101011111
aaaaaaaaaaaaaaaaaaaaaaaaaaaaaaaaaaaaaaaaaaaaaaaaaaaaaaaaaaaaaaaaaaaaaaaaaaaaaaaaa1011111111100111111aaaaaaabbababababaaabaabaabbaabababbaaaaa1110101111111111111
1011100101111101111111110101010110111111111011111111111010111111110110111111111010111111111111001110011110110212220122222222212211102222111110101011111101111111
1111111111101000011001111111111110101011111111111111111111101111110111111111111111111110111111010111111111112222212102122220221120212220211101101110001011010111
1011110101111111111111001110011101111111111110111101111100010111111111110111011111011010111111011011101111111021211110112211221122012122011100011110010111001110
0111111101100101111101111111101111110111111101110111111111111111110111111111111111111111111101111111001111111021111122201111021220122222211110101111110111111111
0110110101110111111111110111101101111111111111111110111111111111011111011110101100110111011110101111111110121012121212122211111011120220011110111111111011001111
1110110010111011111111111111111101101011111110101011111011110110111101111110111111111111001101111111011111102111011022021111110202211122011111011101011011011011
1110100011111111101111111011100111111111111001111100111111101011111111111110111110111111111111111111111111012211211012122111101222111122001111111011111011111111
1111111111111111111100111111111111111111111011100110011111101011111101111110001100111111011111110110011111021222122201222110111111212122011111011100111001111111
1111101011110011111011111111111111111111001111111101111111101110111111001011101111110111101110111111111111121101112112222111111212221111001111110111111011101111
1101100011111101111111011011101011110111111111111101011111111111111110111111111110001110110101111011111010111221212222221211100112121121211111111110110111101110
1111111101111010011101111001110111111111111111011111111111110101111111101111100111111111110111110111111001112212001122222110201121111210211001111110010110110111
1011111111111111011111100111110111111111111111111111110101111101010011011111111101111111111111111111110110101211002021220111202101211201010011111111111011101111
1011111111111111111111111110110111111111110110100111101111111111011111111111010110110111111111111111101111002122211022000221122000202201111111100101101111111110
1012111002122012112121001111111111001101111110111101111111110001111001101000100101101101110111011111100111101221122012122222222222111021101101111101011111111011
1221211101211022111111111111111101111111011111111111001010111111111010111111001100110110111111110111111110121122121112121211021221122201211110111011111101111101
1122221011210022112121100111101111110010101101111111111111111110101001111111111111111110101111101111101001100001111111001111111011101111111011111111110101111111
2111021011222222102001101111111111111101111111000111111111011110011011101111111011111111110110011011101111110011101100010111111110010111111122211202221222211211
1220122212201212122020011111111111011111111111100111001111110110111100111111111110111111110110111110111010101111111111111111111110011111101122201211120121020220
2002011201102022020111111111101111101011110111011111010111000010101011111111101011011011011110111111111101111101110111111010110011111220110112110222120221220222
1112120211112110020221101111011110111110111110110101010101111011111111100111111111011111111111101101011110101111111111111111011111111202002122222220202110022222
baaababbaabbaaaabbbabaaaaaaaaaaaaaaaaaaaaaaaaaaaaaaaaaaaaaaaaaaaaaaaaaaaaaaaaaaaaaaaaaaaaaaaaaaaaaaaaaaaaaaaaaaaaaaaaaaaaaaaaaaaaaaabbbabbbba1212120121202220002
02220111021212222111201111101110010111111111111111001111100111011100111111111011111010010011101111011111011011111111111110111111011111212111b2202222002212222122
22221221112220222122211111001101111111111101111101001111110111110010011111101111111111111010101111001011111111111110110111111001111122202201b2122120202112122122
21020122120121210221111111111111111111101111111111101111001100111110101111110101011110011101111100101111111001011111110110111011110121112211b1212022002222221222
12201212122221211221211111110011111110111110111110111111111111011111001011111110111111111011111101111110111111111101101111111011111121101122b1202120120222212022
11011002022012222120111111101011110111101100111111011111111100111101111000111111111111111111011111011011111010111110111111111111110011021212b2212020022220000112
12121101212111021211111101111111111111110100101010100111111101110011101111111011111101111011111111111011011011111011101111011111101122212222a2211222102120201212
21211121122112121122211111100101111111111110110110110101101100101111111010110111100101110111100110111101111111111011111111111110111111200210b2221220022110102222
12122211212111212111011111111111011111111110101101001111111011111011110110111011111111011110001111101110101000111111111110111111110112110001a0222102100221222022
21111222121122222010011001110011111111011111110111110001011111111011111111111111111101111101010011111101111111111111011101011111110100210122a0120022210212020222
12112221121112111121111111011110110110111101011110101110101111111110011111001101111001111111111111111110111111111111111111111111110011102022b2010122020212011200
21201110221122100210011111010111110111111101111101110111110111111101111110111111111011101111101111110011111101011111111011111111111100121111b2022222222202010022
12122100201112211221010110111110101111011111100111111111111111101111100111111111101111111011111011111011110111111111111111111110011102121111b0202212221020202022
11012221111012002111011011011111111111111111110111111111101101110111101110111101111111101111100111110101011111100111011110111111111102102121b1121202022220202202
20002221111110112210111101111110110111111011111111011101101001111111100100110111101000111111111111111110010111011111111111111111101111200012b1122121212102221120
11221112211122012021111011000011001111111111011111111100011111111111110111010011111111100111111011111101111001110011111111111111101111212202b1212122011202121202
22211010111121212202211110111110110111111100111111001111111111111111111111111111111111111101101111110111111111111111111010110001110102220212a2220102222212211222
22220101220211212212111100111100111001111111111111100111111110111011101110111101110111101100101111111111011111111111111011100111111011212222b0222022222220221122
22220011221111022200211101111220111220122111212221211211022111111111111011111111111111111101101111111111111110111111101101111011101122010111b2212201202122021202
02211001120212121101111111110122211221022222101112022221121101111010110111110111110111111111101011111111011111001111111111111110010122102022b2122102222222222022
21220120121022002122010111101121201111120212212121112210201111011010111011011101011101111101111111111111111111111101010111110111111012122122b2222022200220222122
00111222120111211212111010110211110011012111221222201212201001111001011011011111011101111111111110111110101111011111111111110111111121111120b1220212212222202110
22020220121222202201010110110010222120011022212110221111221110111111111100111111101111110111111111111110011110011101111111111101111101212212b2022211200222222222
11001110111011101110110111111112210122222222102121212022222111110111011111111001111001111101100101111111010010111111111122020211121011222221b0222022022010020022
11111101110101111101111101101021022201100012210011022021222212022212101110121221121110111011001011111111111111111111111212210212201222122122b2022202221212122200
11101111111110111111111111101111022112101220112122202120221200121102122112221221201222011111111110110011111111110111101021011212102222011112b1212212202221220212
01111111111111011100110011101112220112111121011202110212202112102212202102010210202020001011010110111011101111111110111021220112211220220221b2222222012221202020
01001111111111001111111100111122202220112202211222212121122212202121110211112120112011101110111011111011111101110001101221220010122221202221b2221202222102112220
00111111110111011111111111111102221210220110101221112221212101222002121121211122102201110111011111111010111101101001011011220200020011211121a1221200201111110111
11111111111111011011111100111212001122200112210112111122111202222000111002221222010011111111011111111111111111111011111021221211122122211012b2111212211101111111
01111101011110101111111111111102111020011011211002110212212110102112220211221101022121111111111111011111111111111111101211211212111012122222a2201201201001111011
11111011111010111001111001111101111211201022212022120120222212110122121122111221121221110111011100111001111011111111111211220220111111011210a2021021201100101110
10111111111111111110111101111020222112201210022112212102212112112212120022212101121001111111101011100010011111011111110211210122100101222111b2012122211010100111
11111111111001011111111011111001022120212202212010001222112121112202101220012210212211110111111011111111011111111111111222112002011020222102b1201210110111010011
11111111101101111111111110111211011122122012121111201020212100011201200112221122110111110111110110101111111100111101101210202201122221221111b0112110111101111011
11011111111110101111111111111122211102222110112202120002222101111111021220121112112121111101111111111111110011111110011212112220122122120100b0221111101101101010
11010111100011110110111111101111001020011211222012110011222220120212112202112012222222110111111111111110111011011110001212222111201120222211a0122020211111110111
11111110001101110010111111111211112111222222021102212111222121102101122002011101220200111111110111110101111001001111010212201122201211120001a1212022111111111010
11101111101111010111001011111101110022101201212002120000202221221122202022121021211221011111110111110111111111110101111121112211212121121212a2111120110000111111
11111111111011111110110111111121221121022112212112122010212112121121122121121212111011111111111111000111111011101110111220022211202112211222b2110101000111111111
01111110011111111011111100111021102122221121221000102212222112121222120111202202111222111110111111101111101111011101011222212010122201212121bbaabaaabaaaaaaaaaaa
1111111111111101110111111110120221111112020221002212211210121210211112010220221000212200011101111000101101111101101111011202001211211010122212012021011111111101
0111111110000111111111111110022211022202112111202202220022221001111002110012222121012111111111111111101111110111111011021101120220122112011122011221110101111111
1010110111111101111111001111101211021212220022211011020220211121212201202111111110212111111111111111111111010011111110101211212111121022201112121002011111110111
1111011101110101111111111011011002021221100201101021211202212222122122212012111211201201010111100011111101010111111101112221201211221220112202121221101101111111
1101011111111110111111110111112211111100020022010100021122222001220112210111222112210211111111011111111111111101111111122210121112202011201202120121111110111110
1111110111011111011011111111111021122020121022121121120122202122222221111210020121122210111110001111011111111111111111121111011010212122011211112112110111110111
1101011000111111111011111110010111121002211222220210021122222120021212221110112022122111111111110111110011111111111111120210002221111101111212111212211111011111
1011101111111111111111101001111111111111010111111111110111001101121221002212021212122211111111011101011111001110100111120002222020112200110212212011201111011111
0111111111111111111110111111111110110110011111111011101101211110211012222111211110110210111111111111111111111110111111120111122212101101211222120121111011110110
1011011101101011111111110111111101011101001110110111001112221211221221111220211112202111111110111111101101110111011001120222200222201221101122201112210101010011
0011111111111111110111111110111111111011011111111100111011212121221121111121110210202111111101111101111101111011000111122210001212012010011011222022011111100111
0111111111111111111111011111111001101001101111111111111001221112100022211202121201221011111101001110121111122121220202221020222002221202221211221102211111111111
0111010111111111100011011101001111110111101110111101101001221102122010122111221120021210001110111011110210121222220121211121012202211111111111111111111011101111
111110111111111111111111111111011010100111111111111111111111111001100101100111101111110110110011110111201022002102220112122122101100110101111101111110101101111a
aaaaaaaaaaaaaaaaaaaaaaaaaaaaaaaaaaaaaaaaaaaaaaaaaaaaaaaaaaaaaaaaaaaaaaaaaaaaaaaaaaaaaaaaaaaaaaaaaaaaabaaaabbaaabbbbbbaababbbbaaaabaaaaaaaaaaaaaaaaaaaaaaaaaaaaaa
1111110111100011111111011111001111111111111111100101110101111111010101010011110111111011110111101111112120022221012022021112222221111111111111111110001111111111
1100011111111111111110111111101111101011111111011111111111011111111111011101010111011111010110100111121012021101021120111021122112211010111111111111111111111111
1101111111111011111001110111111111111110110111111110111011010101111011101111110001011101111101001111112022222221222012222122111220011111111111101101111011010111
111111101111011111111011111101111111001111111110011111111000aaaaaaaaaaaaaaaaaaaaaaaaaaaaaaaaaaaaaaaaabaabaaabbaaabbbbbbbbabaaaababbaaaaaaaaaaaaaaaaaaaaaaaaaaaaa
011001110111111111101011110111111111111111111111111010111011a110110111101000100111110111111101111001112120211012121221112222112121210111111111111010110111110111
111111111111111111101011111111111111111101111111110111110101a101111111101101101011110111100011111111110212221112221211021120222211011100010100110111011111110011
111111111111101110111010111011011110111110011111100110110111a110111111011001111110101110111111111101122112111202112101011112010122201111101011110111111011111111
111000111011111110011111111111111100101111111110111011011111a111111011110110110111111101111101111111111121010111120120112211000120011011111110011111100111011001
111110111111100100010111111111111110001111011110001111101101a111111101111111000110001111011111101111012221222111101022211211220111011100110111001111110111001111
111111111011111111111111111111101111111111001011011111101101a110111111111111011110111101110100110111112022111222122120000211122021201101110100111111111111110111
110010111011101010111111111101010111111011101101111011101001a110111110110111111110111101111110001101110110210212122112212112001121211111111100111111111011110111
111111111111011111011111101011010101111111010111111111101111a011100111111111111111111111111111111111012021110220211021211112102221010101101100111111110101111101
111111011111010000111111111111011111111011111111011001111111a011111111111101111110111011011111110010111101120212201221222112120011101111111111011111110111110111
011111111111111101111110011111111011111111110001100101111111a011111111111001110111111011110010111011121111102002121211101112120002211101111011111111001111111111
111111111111111111111011001111111101111011101111011011111011a110011111010111111111111111111111100111112211102222101221222111122121011111111110110111111111011111
101111111011111111011111101110101111111110011111111111111110a111000101111111111111111010111111101111112121211212222111220211101020211111111111111111111011011111
111111111100010001011110110111110110111101111111111111111111a111101111111111110111111110011011011101121122221120221112111100200112110111000111101001111111111111
101101011011011111111111111111111111011111111111110111110111a110110111100110011101111101011110111011010102212221212021211210022120211011111100110010011110111111
111110111101110111100011011011101111011111111111111111111110a100101111111111111111111111110101111010120201000122212112101011220112201111111011111111010111111100
111111111011111111111111111100100110111111110101111111101011a101101101111111111111101101010111111101120011212112222202210222111022001111111111111111011101111111
