(93,147)
(8,11)
(20,42)
(35,20)
(71,109)
(108,89)
(32,6)
(24,73)
(98,96)
(77,133)
111111011111011111111110111111a1011110100a101101111111101111a111111011111011111011111110001011111111111111111011111010111101111111011110111001110110111101111111
111100111101111100101011111111a0111110110a011111111110111101a011111111101111111111111101111111000111101101110100111111111111111111011111100111011111101110011111
111111101111110110100110000101a1111111100a101110111101111111a101101111111101111011010101111011111101111111010111111110001111101111111000001101111111001111111111
011011111100111110111111100111a0010111110a111100101111110111a111111111111111011111111111011111111111110101101111111101111111110111111111011111110111111000111111
111111111110111111111111011001a0011111101a110111111111111111a110011111101110110110110101101011111111001111011111100101111111111101111111110111111111110110011001
111111111111111110101011101121a2201212212b121222122011121111a111011110111111111111111011111100111110111110100111010111111111111101110111110111111111111111111101
110111111111001101111101111000b2221221120a112020201212212111a111111110111111011111110010111011011111111110111111111111111101111111111100110111011111011111111101
101111111111111101111101111222a1112110121a121220222011021111a111111111110101111111110100010011110110111111111011110111110111110111011111111111111111111011111111
110111110111011111111110111122a2022102212a012211111212211110a011101101111101111111111111111101101110111111001111111011110011101111111110110111111111111111111111
111011101111111011110011110220b1220221221b122202111122202121a101101111110111221112122122110111111111111011111111110101011111111111111111110110101111111100011111
101111011111011111111111111210a1102011002a111210012021211102a122121022112102020011120211110010111111011101101111111111111011001110110100011111111111111111111111
110111110110111111011111011111b1111202221a202010202121121120b011111111021201101222221012011011101101111011111111110110010110110100111111011111011101111011111110
111111111101111110111111010111b1200110212a221011201122202021b111111101011020112001021211101110111110110011111000111111011011101111101111110101110011011101111111
110111101101110111110111100211b2011212121a110100211112002111a222102201010200120221211202110111100111101010111111111111011111111111010100110110011110011111111111
110111110001111001111111110211b1121022211a022020201012120121b222201121202102220102011221101111111011111111111011111101111111111111111011111111101111101110111111
111111111111110111110111111112a1200221112a120011021221010100a111222212222022021212102021111111111001111111110101101111111010110111111111101111011110110111101111
011101110011111110111111000221a2220201210a121020012202221120b120000210221012120102021012111010110111110111101110101111110111111010111111110111111111111111011011
211111212220120221221100111112b0222110110a202221202211222102a2212122221111222221102111020111111110111011111110110011111111111111110111110110aaaaaaaaaaaaaaaaaaaa
112221021011121211211111000012b1221122201b111101221021222021b0221020211121221112211221221011111111111111011111111111011101111111011111111111a0011110111011111111
111021212221211022200111111010a2221110111b211002002102211021b2121022121112221221211011211111110111110111101110111111111101111110111110101111a1011111111101111110
221212220122022220220011222112b2222122122a110002122102000102b0111212110122022022202012020010101110110110111110101011001111111111111111111111a1111101111110101111
211112022122222222122121122202b1221011212b001021120012221112b2122122011111210012211202111111111101110110111111111111011111111100110011110111a1111111111111110111
121201222110212210220211221022a1120022111a221212112220202121a1112200022111211010020222211111111110000110111111111111111101111111110111111111a1111011111111111111
121221212022021222122211221122b2121110121a201202200021222122b1010222202012111122220222121110111111111111111110101011101101111101111100111110a1111110101111111101
212212222222202122221120212222a2221222111b102221022001011010b2112120012112212212101121111111101111101011111111011111001110111111101111110111a1101110101110111111
001122212120221212222210221220b2222201122b012222102022201121a0121211012112110201220120121111001110011011011111001110110111011110111111101111a1101111011111111111
201210210221220222221200201122b2222110120a121211212210112101a0220210221112220200112212211111111010111111111111111011111111110111001110111110a1111111111011111101
222201122211221222221112211110b2211020112a211112101212112021b1112012212210211212010022121111101111101011011111111010011111011111111111111111a1111111101101111111
121112022212122120021201212222b1221112211a012222221121220100b2112202112111111222220012201111111110111100011111010101011001111111111111111101a1110111111111101111
201122222222022221202011211201b0202220222b220222221011222021a0120222012222011120122121111111110111111011011110111110111100110110101111111110a1111011111111111110
122122202020200020212012122222a2101122121a201121211021102112b0111102102221110010011121201011111111001110111111111111111110011111001111111011a1111101011111011100
202222222202212022202211112112b2222112120b212110112101201111b1122002101212212101012122111010111111111111111111010111111101111111111111000111a1111111111101101111
120212221222221220202121212222b1220221121a111012002112112111a2020112201110110022201110121111110111101110111111111111011111111111111111011111a1111011111111101101
112122222020222021022122022102b2222012121b122101211102122022b1111121120122101211202211111101101111000111101011011110111101111111111101011101a1010111111001111110
022222222022122222122122122022b1122012122b121201222122221110a1120102100221122001120201020111110110110110101111110101111111110111111111111111a0111001011000011111
212212222122220012221210221011a1200111001a110110111011111110a1011212221221002101112212211001111111111100001110111111011110111111111110111111a1010011111101101011
220112102012222210020012120221a0010111110a110111011111011122a1222120202122102122211011220111111111010011110111111010101101011111011101100111a0111110111110111111
102012202220020222020212022012b2102001101a111111111101111121b11111122211102210201222120111111111011111010110110011111111aaaaaaaaaaaaaaaaaaaaa1111101111011110110
202122202102122222122001122120a1110111111a111111111111111101a10122120100121020122122110111101111011111110111110111100110a111111011111101111111011101111111111101
212202022210202012111121122221b0211111111a111111101110101110a11111111111111111111000111011111101101111110011111010111111a111111001101111100101111010111101101111
102122222201222222222202212011b2122111111a111111111111111110a11100111111111110111111010111111111111111011111111111110101a0111101111110110111110001111101011aaaaa
121102202022222102220210201110a2202111111a111111111011110011a01100111111111110111111110111111111110101111111110111010111a1111111010010101100010111001111111a1001
212222212222012211221212112221a2212101101a111111111110110111a11111011111110101101111111111111110101011111111101011100011a1111001111111111100111110111111111a1111
212211122102002222021212202221b1222011011a111011111110110100a11100111011111111110011111111111111101101111110111111001111a1111111010111110011101011111011101a1010
122212201202222012121201020020b2222111111a101101111000110110a00101111110111111111011111011101111101010011111111101111111a0111101010101110111111111011111111a1111
202122102022210122111111111012b1110111110a111101110101101011a11111110101111100111001101111110111111010110111111010111110a1111111010111101111110111111011111a1100
201122201102210020222121111121a0202011110a111001111110111010a01111010011111010111111101111110110111101110101111011111101a1011110110111111111000011111011101a1111
011100002212102210012212122221a2021111001a110111101101111101a11101111111101111101011111111111111011111111111101111101101a1111111101111111111111111111011101a1111
011112211121012202211222020112a1101111111a111011001111111011a10101111010001111111111111001111100111110111111011101111111a0111110111110111110111111111111101a1101
111010120202012002221220110220a2212101111a111111110111111111a11101111111111100110110111111111111011011111101101111011110a1011110011111110110110111111111110a1001
011100110111111111111100111111a1111110111a000111010011110111a10010000111111100111101111011001111111111111111111111101111a1111111111111101101011111110011101a1110
011111111111111110101111011111a1111111110a111101111111001111a11001011111111110101011110011111110111111111111111100111111a1111111111111101111101111111011101a1011
111111101101111110111010111001a1011111111a100111100011111101a10111111111110111111110110111111111101111111011111011111110a1111111110011111010111111111101111a1010
111111111110110111111111111111a1101111111a101111111111110111a11111101111101111110111111100101111111001101111110001011111a0110011011111111111111101111001111a1111
011011101111001111011011111101a1011001111a111110101011111111a11111011111111111011101101110111111111101111011111111111011a1110011111011111110011001100111101a0111
111111011101111111001011101101a1110101111a111111111011111111a10111011111111111111011111101111011111111011101111110111111a1001110111101011110011111111111111a1111
111111111111111111101111111100a1011110110a100110001111111111a01011111111111111111110011111101112111221112212222221222220a1011111111010100101101101111111111a0111
111010111111110111111111110111a0111011111a111111100011101111a111001111111111111111101110111110222012abbabbbaabbaabaabbaba1011011101111110101110110111111010a0101
010110111111110111011111100111a1111101111a111111111111110111a111111010111111101111111011111111220211b211022121012102222121000110011110111101001111111111111a1111
111110110111111111111011101111a0111111110a110111111111100111a111111010111111111110111101101110211102b221110020111021202101201101111111111110110110110011101a0111
011011011111111111111110111111a1011110011a111011110111110110a111111111111110111111111111111111211112a2201222221122221211012111111111011aaaaaaaaaaaaaaaaaaaaa1011
111111111111111101111111110101a1111111111a111111011111111111a111111001010111100111111111111111220122a1221221112122221210121111011101111a101111101111110110010111
111111110011001110111110111111a0111011111a001111111111111111a011111111110101111111111111011001111222a0222212202122122112000121111212211a202011111100101111011111
011111011111101011111010111101a1111111011a111110011111111110a110111111101011111111111111101111211111b1212201210110212222020111112010112b221222212222011110110111
111111011111111111101111111011a1100111111a110100111011110111a111111110111111110111111100011101101222a0122212102200111110002211212022010b122122210110111111111111
111101111111101011101111010111a0111110111a111111111011110110a011111100011111001111111111111111221122b1221122122212001122120212022011112b121122111021111011111101
011011110001111011101111110111a0111111111a110011001111101011a110001111101111101010101111001111101020b0211101212022211222201010122212022a221220101110111111111111
111111101101101101110011111010a1110111111a011111111001111111a111101111111111101010111110111111212121a2210021100122112222201010122110201b222211221122010110111010
110111111101110101101111111101a1101111111a111010011101101111a111111111111101111111111111111110012211a2121100122212212122101222222222121a022222221211111111111111
111111111101111111111110111111a1111101111a001101110100111111a101111100111111111111101011110000122221b1001122202122211021222120210210122b211001210221011011111110
111111110110111101111111111111a1111111111a101011111111111110a111010011100111111111111101100011112100a2012212021112222000020221010221022a121211122121111011111111
111011101101111011010111010111a1111111011a101111111111101111a101111111111111011111111111011101202121b2221201002211021222122212112010101a201112222102011111110111
110011111111111111011110011111a1111111111a110110100111111101a111111101111011111111011110111110211112b0110122220122121211010201101111121b021111120210111111101011
111110111111011111100111100101a1111101110a110111111100111110a111011111111111110110111111111101012212b1211211022020122022022121100221102b012210212022111011111111
111111100110111111111111111111a0111110111a111110101011010101a111111101011110111111101011111101111210b1110202111121002222022212022202221b221220101112110101101111
111111011110101101110011101111a1111011001a111111100101111111a111101001101111010101111011111011012021a0112220112110222122121012202211011b122222111110101111101011
111111111110111111111111010101a0110101101a111111011111011111a111101101111111111111101101101111212122b2101012002222022022202121222112201b211012110101110011011101
010110101111011111010010111111a0111110111a111101111111011111a111110111101111111111001111101110222011b0211201021012001202221221012022120b212022122122111111111110
101101111011111111011011011101a1111001111a101110110111110111a111111101111110111101101111111111212012a1021122222202021112220010220011212b021021210102100111100011
110111111111111111111001111111a0111101001a101111111111101011a111011111010111111111111111011111200111a1122111110101110212022021221212211b220021221111111111101111
010111101011110111111111011100a0111111110a101111111110011111a111101101111101011101111101111011102222b00211201202021babbbbbbbbaaaaabbaaab222220221212111110111100
101011110101111111001111111001a1010111111a101011111111101111a011111101111101101111101110101110210211b12202122222101a10222201210121221220122011210121111111101111
111111101111110111111101011111a1111001011a111011111011111111a111001011011111101111111111111111121202b11010021202112a02201022222211220222012121220112111111111110
101101011010111101001101110111a1101111101a111010111111101111a111111110111111111110201022110022221222a22122002022011a11222222112121212202222222200012011011111111
011111111111101111011111110010a1111111101a111101101111111111a101111010110110111112120110201221220202a02210212212011a12222122111220012221102012211121110011011111
011111111101100111101111001111a1111111111a100011110110111111a111001111111101111110112102002020121222b11122212220022a01222112211212122212121111112212111110111011
111110111011101010110110011111a1110111110a011110111110100111a111111111111110101110201221221210222122a11221111001111a11001010121120012112012021211020111111111111
111101111111111101111111111101a1111111111a011111101110011110a111111011111111101001210221211212112122b21111022100010a11212122112220100210112202201012110111101111
111111111100011010011101101111a0001111011a101111111111111111a111111110011101111111101012111211120112a20111121210111a11120111121122101212121202022222100111011111
101111111011111111111111111111a1111111111a110111001110110101a111011100111110011110211121021110212201a22212001111111a11212210012211222221022221122121110011100111
111111111111110111111111111010a0111110111a111110111111101001a110111110110010110010011121222220102021b11021212210111a11110212112221011122222000112220111101001111
000111101010111110111101110111a1111111110a111011111111111111a111011101111111110010021022211100212222b02022112011010a11202210202012202222002202101022110010111111
101110111111111001111101111111a0110110110a111111001000101111a011101111110111101102002101202212012102a00221221101011a11111111110111110110111001100110011111111111
101111011111111110011111011011a1101011111a111111111111111111a011010100111111210112102222021211202222b12112222121011a11111011100111011111111010111111011101111111
101011111111110101111111110111a1111101110a111111010111111101a111111110111112020002022220220202212020b21211210221100a11110011111111111111111111100111110110111111
111011111101111110111111110011a1111100101a110101111111110110a111101001111112121210221122222222222112b22012222010111a01111111111111111111011111111101111011101111
111111101111111111011111111101a1111111111a111011111101111111a111110111000112221212122012201022122221a02212210110001a11111100111111110111111101110111010011101111
011100100011011101111111111111a1111100010a101111011110101101aaaaaaaaaaaaaaabaaaabbbbabababbababbabbbb01202210210111a01111110110111111100111110111111101011101110
111111111000101100101101111111a1111111011a1111111111111111111111111011101000100022220011122212222222220201112111111a11111110110111111111110101111111011111101011
111111101110111111111001111111a1111111111a1101111111111101111111001111111111222212202210222111110222222222212010101a01011111111011111111111110111111111111111111
111111111111010111000111011011a0111111111a1011111101111111011111011111101101101122200212212022121221212010102220110a10011011111111111101011011011110111111111111
101111010111111011101001011110a1101110111a1101011111011111111011111111111111102102212220122222002021222210121101110a11101110101111110111011111111111111101111011
010111011100011111011111110101a1111111111a1111011101110111111111111101111120221102222221222222121022211202121121111a11001101111111111111011111111011111101111111
111010111111111010001101111111a1111111111a1111110011111111100101111111111002222122201222010212222122122011212121111a11111111110111110110010111111111100101100101
111101101111101101111110101111a1111111101a1111111111100111111110110101111011222012101211221202002211222112100211111a11111111011001111011110011011111111111011111
011111111111100111111110111111a1011101001a1110111101111111100111111111101111000022122022202202100222222212021221111a10010100111101110110111010101111101011111000
110111111110111011011111011111a1111111101a1101111111111111010111011111111011110212220222012020122202122001221121001a10111101111111111111011011111011111110111101
111111011111111110111111111111a1001111111a1010101111110011101111111101011122212221222221222201002201202222211020110a11010111101111110111111111110110111111101111
110111111111110111111111101110a0111101110a1111111111011011010110111111101121201112121220200022121122222222201221111a00111110111011111111111100111111111011101111
011111111011111111111111111101a1111111111a1011111101110111011011111010101110101121212120020222221211102112211210101a11111111011101111110111111111011010111110110
011100111111101111111110110100a1010011110a1110011111111111111111111111101021021212221002022002020120222202100011101a11001111111010110111111101111001111111111101
111111101011111011111111101111a1111010011a1011011101111101100110101111100122212121212221201220212222220211110201111a11101111111101111111011011111011011011111111
001111110011111111111111111100a0111100101a0011101111110111111101101100010112100222222222221202121220220111221101111a01110101111011011001011110101101110111011110
011111110111111111111111110111a1111111011a1011101111111101110111111110110122222212222200112211021122210211110100010a01111110111011001101111010111111100011011011
111111010110111111111111111110a0001101111a1011011111110111101111111110101102212020222202120122212101212001110111111a11111001111111010011111011110111101001111110
110110101111111111101111101111a1110111111a1011011111001110111111100111111121112222222112222210112222101010111101101a11111111101110111011110111111111101111111111
101111111111111100011111111011a1111111110a1111100111111111001101111001111012012211221102210111011022020201111111111a11111111101111111111111110111111110111011111
110101111011100011011011011101a1111011111a1111110100111110111111101111111122002111222120020021011101221111111011111a11111111111101111110011111100111111111011110
011011001111111111101111111110a1111111111a1111010011110101111101011110110110221002221212022112211222122111111111101a11111011111111011111011111111101110111110111
101111011010111111111011001010a1111100110a1111111111110111111110111101111021122212202122002121021210200001111111111a10111111111111011111101111111111011101111111
