(14,157)
(117,158)
(49,81)
(26,129)
(49,145)
(34,74)
(33,73)
(66,137)
(97,87)
(112,10)
1101111110011111111111111001111111111111100111110111110111111001101110001110111101110111011111110111a1011111110111011001111111a101111111111111101110111011101101
1100111110111111111101110111111111101111111101111111110101101101110001011111111111010100100011111111a1111101110111010111110111a101111111111111011111100111111111
1011011111110100101111011110111110111110101111111010101111110111110111101011011111101111010111101111a0111100101111011100110111a111111111111111101111111111111111
1010011111110101111111100111001111111111111110111011011111111011110011110110110110011111101010111111a1011111110111111111111001a101111111111011111011011011111111
1011111101110111111101101110111111101011110111111001110101011000111111011110011111111010101111111101a1111110111111111101011111a110111111111111111111101001111111
1111011111111011101111111011110111111111011111111111111111111111101111110001111001110110101111011011a1111101111011111111111111a101110101111111011111111111111010
1111111100101110010101111111111111111111111011111011111101111111100100101000101011011101011010111111a1101101111111111011111111a111100001111011111111111111010111
1100101111111100010011111011111010110111111101111101101111010111001111101011001111111101011110111101a1111101100110111111111010a111111111111111010111111111111011
0111111101111110100111111001111101111111101111111101111111101011111110111111101111110111111011111101a1111111110111010011101111a111100110111011111111111010111000
1110110111111111101111111101100101110111111111110111111111011111101111010110111111011110111110110001a1111111100001110101111010a111111101011111111110111011111110
1101101111110101111110101111111011111001101111111011001111011001111110111111110101111111001001111011a1111111111100111110111011a101111111101111011101010111111100
1111111111111111111011010011111111111110111111111111111101111111011111111111111111011110111111111011a1111011011101212221020122b110102212112122211011011101100000
1111111111111101111111111101111111110111111101111111110100111111100111011100111111111011111111110111a1111111110111020022101221a102120102212121101111111111111110
0111111111111111111111011111111100110111111111111101011111110011111111111111111111111011111111111101a1111111111111010102220102b001120102011122111111011111111001
0110110011110111101110110010111011111101111111110011011111101110101111111111111111001111111111111101a1111111111101011010102212b111222121112122021111011111111101
1101101101101010011111011111111111111111111110111010111111111111110111111101110001111111111010111111a1101111111111102012210212a111122220210220111110011111110101
1011111100111111111111111111110111011110111110101011111001111100111111101011111010111010101111111111a1011110111101220122121121b110220122212221020101110010111111
1111100111110111011111110110111111010110110101111111111111101101101111111111100111111111111001110111a1111010111111010121120111a012121101001211111111101111111111
1110100111110111111010101001111011111111111111111111111001210022221122011022221010202111101101101101a0101100111111210220222102b211210202022211111111111100111111
1011001111111111111111111111110111111111111101011111111111122222202222200222022022222222111001111110a01111aaaaaaaaabaaababbbbab222222202102222111111101101011111
0011111110101110110011010111111111110111011111111011101101120102222122120220122021222211011111111100a11011a11110111110222110112022012102021110121111101111111011
1011110111111111111011101110011110111011100110111111111010122202202202020202122221220222210111111111a11011a01010110200112002212212111122212121111101101111111111
1111111011111011101011111111111101111111111111110011100111012220222200222022102220222212201111111011a11110a11111110022120100222212011000122211211101111111011111
1110101111111101111100111111110011100111110101111110111111221220211222212222111202222221211011011001a11110a11011101122201121202020012201122020210111111111111111
1111011011011101111101111111111100110111111011111110110011102202120211222222222202202222110101010011a01011a11001112022201101100211221112121012211111011111110111
1100101111101111111101111100111111110111111111111111111101122201120210222012202222121211111110111101a11011a11111101112212111021021112220211211110100111110101111
1110110111011111110111111111111011101111111111011111110111222222222122221211122101000020111111111111a11010a10101101011112211210212201022021212211111011111011111
1111111110111100101010111111111111111111111011010111101111221221212222212202220200022011111111111111a01110a11011102012221211011212112112110102211010011001111111
1010111111111110111011101111111010010111111101011111111101202021220122221222220210101202211111100111a11111a11111102100102121011101210011102122221110111111111010
1100111110110111100111111110111001101111111111111110111010122222021222211022021220222220011111111111a11111a11101112201202112112201212212221122111111111111011111
0111110011110111101101111111111111111111101111111110100101112222222211221021222212122112110110111110a11111a11101101221201121212220202021210022220110011111111011
1111111111111101010111110111111110111100111101111010001111220222220120222202202222122202210111110110a11101a11111112122200110222110210111212110210011101011111111
1111001001111001111110111111110011111101111110111101011110221222202201021022222212120102011111111111a11011a01101110001202121201011201122001212021011010111110111
1111111101011101111110111111111111101111111111111010111101022000121212220222210211222022111111111111a01111a10111112211120012222222111111201011001111011101011111
1111011101111011111111111111111111111100111011110111111111022220222222200220222022202202220202221111a11111a11100011101211211121222212220102202210111001212112202
1101111101110110011110111111111111110100111011101010101100222102021222022222122202222022100222221111a11011a00000001100111221221221120201201221022111222112221112
1101011011111100111011111011111011011110111111111110111000112022202222002122002210221222222112201111a11111a01111111020110122212021122121122112201121122102210222
0111110101101101111111101011110001110101001110101101101011122220122222221122222210222022020211121111a11111a11111111222011121211221212222202222110022000112022221
1111101110011111101111111101101111111110111111101111011111202200122022212222210222222222212210210111a11111a11111111121202101111110212122212020221122111020121122
1111001011101110111110111110111111111111111101011111111111022222122202222222222022011222121101120111a11101aaaaaaaabbabbbbabbbabbbabbbbbbbbbababbbaabbaabbbabbbab
1111111111111111111111010101111111101101100111111111111111222222122222122022222222221210212221121111a11111111110112022222200012111120221222222011122211211122222
0111110111111111111101110111101011110110111110011101101111222022202221221222221222022221222022001111a11110110111100111101111111011200022112212201122201002212122
1101110111011111111110111111111111111111101110111010111101122010222120202202220222022222222201201110a11111101110110111111111011111211112010201112022212221122122
1011111011101110110111001110111111111110001111111111010111202212122202220220210222222222202122021111a11111101100100111011010111110110112122021112221201222120011
1110111101111001111011111101110010111111011111111111111111021122222212022222022222220202211121121100a11111111111111010010101101111122121121202010212100201122111
1111010100111100111110110110111111110010111111111111101111222122222020222221222002220222210120211111a01111001111111111101110110011010111222212122202111001010122
1101101110011110010111100111111100111110111111111011101110221221202122222202120220202222222111201011a00011111111111111011011111110121222201010122201222220100112
0010111111111001111111111011111111110110111111111101011111102222222222022210222222220222221112001111a11110101101110101101001111001112210112222102001222222122212
1100111011111101111111111111111010001011111110111110111110120211122012221012122221200222211222211100a10100111111111111110111101111122121200220121110222222121012
1100011101111101001110101101111110110111110110111111110101111000112122112121121112002112210202010110a01111111100101111111111110111221110112202211222222112121121
1111111101011101111111011111111111111111111011111001010011110101112002000220121200112121202111211111a11111010111000111110111111111220211211212212210122212201211
1011111111111111111111111011111111110100100110111110111010111110011121211212121222221012201120221111a11100111110110101001111011121210122001102001121212212110111
1111101111111101101111111111111110111101110101111111011011111111112121121222012110112012112212221111a11110110111100110111011110121022222022222222222202212122010
0111111111011011111111111101110111110111111101111111101101111101002121221211122202010211110212210111a01101110111001101111110112202220022202012222212020222222222
1111101111111111111110111100110011011011111111111111011001011001111220022111011201111211121110201110a01111011001100011001121212110022122012012121221221222112212
1100111111111000111011111100111001011110111111111011010111101111112101201021222222012222121211111111a11101101111110100110112110011120021002212212222212222221111
1111111111110111111111110110110010001111111111111101101111101110112121202202221212111210112121211011a10111110101011111111110220200210220012021202221221222122222
1101010111101111111111111110101110001111110001110001111111110110112111220111221202111220222212010111a10011010011110011110112002101001222022202222210222220221211
1111111101111111011101111011110101111110110111010010111111111111112122121111211211120012212122111101a11111111111111111101101211201212222221222222222221122002221
1111110111111111111110110011101111111110011101110111111001101111110211201002111011122202111211201111a11111111111110011111002122020212202122122122222222201022211
1101111111010111101011111010110100011010111111011011111110110100111221111112011221021122210212101101a11110111101101111111112112012222201010212221122212121112221
1100101101111111011010011111111110111111110101111100110101110110111102122111202211212221112001021110a10101100111111010111020112212222200220221222012220110111120
1111111111111110110110111101101110111111011011101101011111111011101211211211222202222012101102021111a11110101111011111111021120212221102202111221202222211120011
1101111111110101101111100111101111111111111011111111111111111101111112221211221201012200102020211111a11111111100110100111121112101220221212022202020112220001220
1111111111110110111111111101110111111011111111001011110010101010111011111111110111000111101111111110a01110111101110111101101121012220121011221221122121111011111
0111100011001101111aaaaaaaaaaaaaaaaaaaaa011111111111110110101111110101111011111110101111111111111111a01111010111111001111111101200122021201021201102200111111011
1111111010111111111a1111111110111111011a111111110101110011010100011110011110101111110111111111111110a01111111111111011111001211022001211122020121012212211111111
1111111111111101111a1000101111111101000a111110001111111011011110111011111111101101111111101111110111a11101011101100110111122201011201122222120121110022011111111
0010111111111111111a1111101111110100111a110111101101011111011111111001111011101111111111111011101111a11110111101111111111122001212221122022202212210021011111110
1111101101000111111a1111111111111111011a110111111111111111111110111111110111111101001111011111011101a00001110111110111111121222111221112111212010122222011111111
1011111111111111111a0011101111111011111a101100111111100110001111010011111101011101011010111011111111a11111111111111111011012111111112010101122120221212001111110
1011111101110011101a0110101111111111011a111111101111011111011111111010111111010110101010101111010101a01111011011111011011020011111021022222021111212122211101111
1110111011100110111a1111111101101001101a100111111110111110111111111100011111111111110001100111111110a01111011111011110110110221212111222001211212110111201111111
0111111111011111111a0001111111111111111a011111111101011011111110111111111101111111000101111001111111a10111101111110011111101212111122222111221121212101111111101
1111111111011101111a1011111101111111111a001011111111111011111111111111111111111111011011101101111111a11111111110111101110100112020122102122012211120120211100111
1111110111111111111a1110111011111011111a011110110011110111111101111111111111111110100111111011111111a11101110100111011110102220121212122001210022201120111100111
1111111111111111100a0111110101110111111a111111011111110101111001101110111110011000111101101000110110a11111101111111111111100121010121011112222221021220210111001
1111110111111111111a0111110111101011111a111111111111111111111111111111111111110111011101011111110111a11111011111111111111011221022121111212202021211220211111011
1011111101010001101a1011011111111101111a100001101111111011111001111111101111111110101111111111111111a11111111111101101001102022020102221221111211022221111111111
1100111011001011011a1101111111111111111aaaaaaaaaaaaaaaaaaaaaaaaaaaaaaaaaaaaaaaaaaaaaaaaaaaaaaaaaaaaaa10110101011100110110012012221122222001221221121222011111111
1010110111111111111a1101011111110111111aa01111011001110111011111011111111111111111111111111001111111111111110111111111110111111122211221101012111112221210110111
1111101111001111110a1111110101100110100aa11111111110110101111111111101111101111111111101111111111111011101111110111111111111111111101101111111111111101110111111
1111101111111110111a1111001111111111111aa11111111111111011110101101111112212011022201211211221220220111111111101111111111110111110101110101111110111101110111101
1111111101010111101a1111100111111111110aa10111111111111101111111101111012112120212112102212210102011221101011111110111111111110011101111111101111110011101111111
0111111001011101111a1111001111111111111aa10110111100011111110011111111112212222211211010121102011221110001111111110111101111111111111011011110110111110111110111
1010101101111111011a1011111111111100111aa10111001101110011011111110101112221221122102211221202112101101111111111101111110111111110010110111111111111111111111111
1111111111110111011a1111111011111101101aa11101111111111011011110111111100121222202120222121222101221211110111111011111100011101111111110011111111011111110111011
1111111111011011111a1100101011101111111aa11111001111111101101101111111110122121021020222012002122112211010111011101101001111101110110111111111111111011111110111
1110111110011111100a1110111111111100111aa11111011111011100111111101110101022012211121221220212121212021110111011101111110111111111101011011111110110110111011111
1101111111101110100a0111111111101011111aa11111111101010101111110101001111021002222112211012011002212221111111111111111111111001111010011011010010111100111110011
1111111111111111101a1101101111111111111aa10111010111111011110001111111111222200112010020122210101212021110001101111111101111011101111110111011111001101111101101
1111111111011011011a1101110101110111101aa11011111111101011111111101011112220022110120021201221102121100111111011111011111101101100110110101111111110111111111010
0110111111111110101a1111111101101101110aa11111011011111110111111111101112222221202221212222012021021101001011111101110111101110110111111111111011110011111111111
1111111111110111111a1011111110111110011aa11011111111111001111111111110111111201121121102221011120112211111001110111111111110111111111111110111111101011111111100
1111111111111101110a1110111111111111111aa11111111111111010110111011100112012021121111211121122211220121011011100011111010111111011111011111111110011111111111111
0111110111111011011a1011110111111101011aa11011011110100111111111110010112120222122122011012222001222201011101111111111111011101111101101111111111110011111110111
0111101111111110111a1111111111110111111aa01111111010000010110011101011000022220021012211011120111220211111011111110111111101111111001111011111111011111011110101
2220211112220212211b2012011111111111101aa11111110100101111101111111101110112220112222220111221221212201111011111101110011011011011111011110011111111010110011111
2112211222012210122a2121011111111111111aa11001111110111111101111111011111121201111120112012210112111111011100111110011111011111111111001011011111110110100111111
1112220120102210121a2111111111101111111aa11111111110111101101111100001111112012012211122101111212102021111111111111011111101111111111011001100101010111111111011
2011121221221102201a2212001101111111001aa11010001111111111101111101111100202112112200020112221221220221111100111111111111111111111111111101111000011111100111101
2121011222112101221b2111111111101111000aa11101111111111110111111101110111221001221111210002010222101211111101011101111110011111111111111111100101111111111110111
2222100221121121102a0010001110111110111aa11111111011111000111111001101002110021111121211111122211222221111111011111111101101101111111111110111111110110111011101
1222222121021001122a1211111111101001111aa11101111011111111100111110111111212110122201111222021122100211101111110111111111101110101101001111111111011100111111101
2111012222012222110a1201211011111111111aa11111111111101111111110111111011012202221222111221100212212221110111011011111101011111100101110111101111111111111011111
abaaaaabbbaaaaaabaab0102211111111111101aa11010110111111111111110111111112211012111121121212011222022211111110111101001111101111111010001001111111111111111001111
002012211021211011122221211111111100101aa1111011111101000111aaaaaaaaaaaaaaabaababbbababaaaabbbaaaaabbbaaaaaaaaaaaaaaaaaaaaaaaaaaaaaaaaaaaaaaaaaaaaaaaaaaaaaaaaaa
111211111021222111020201011111111111011aa1111111111111110110a101111111110111221220211022110220012221211111111110111111111111111111111111111011101101100110111111
221012212202012101200122211111111111111aa1111111111111110110a111110101102021212222211111222112021021221111011011101011111010111111111001111111111101111111111100
111110110100201101110120211100111110111aa1101010011101111011a110111101112211111111011220222221221101110101011111111111110101011101011111110111011101101111101111
022222202220212212011100111110111111111aa1111001111001011011a001011111012122001221212011110212211222121111111111101111011111111011110111111111111111111111110111
021201202201212112222200111110011111011aa1011011111111111111a111011111112112011010212111110011122201110111111101110111011111110110100011111100110111110111010111
110111121111112021102222011110111111001aa0101110110111111111a111101111111111001111111011101111010001111111111111111111011111111110011111010011011111111111111110
211212121021221112011220111111111111111aa1111010111011111011a111101111011111111101001111111111111111011111110111111110111111101111101111101010011011111111011101
210200210020022211112222211010100111111aa1110101111101111101a011111110111111001111010111111100111111111111011110111001111101001110011101111011101111010101111011
221102120212122121011111111111111111101aa1110111111011111111a001101111111111101101111111111111011111011011111111111110111111110111111111001111111110110111110111
211112202012110020111112011011111111111aa1011111011101110100a111101011111111111111111111111101101001110111011101111101101111011111111111111111111111010110111011
020021211121110010221201211011111011110aa1111110110101111001a111011111111111111111111111111111111111011110111111110111111001111011111100101111111111111101111111
212211112122220110202021011111101101010aa1111111101111111101a100111011101111111111111110111111011111101011011111111001111101111100111011111011111110011111011011
120112120202112211121221100111111110111aa1111100011111111110a111111111101111111101111111111111101011111111011111011111011110110010110111111111111111110111111111
