(57,145)
(66,1)
(5,114)
(31,106)
(43,135)
(72,94)
(57,157)
(51,59)
(100,141)
(5,136)
1111001001111110111011100011101111111110101111111111111110011111110111111110111110111111111011110110111221111010102120012022221200121111201bb2110222020111111111
1011010011110010110011111011111111111111101111111111111111110111100011111111111111111111011011111111111212102211011121100022212222002111011bb0012121122111111110
1111111110011011101111111111101101111111111111111100111111111111111000111110111100111011110111011102122110100200210222210222220212120202022ab1100121011111101110
1111111111111111011111111111110110111111011111111110110111111110111111111011101101101101011100110012121122120121011202101020020201022110122aa0111121102111111001
1011011101010111111110111001111110011101111111110101101111111110111111111101111111111101110011011112111101220020022020222222222200200201222bb2111210112111111101
1110011110111111111110101111111111011111011111100101111101111100011111111101010011111111110101101112112211120110012120021102122201121001212ba0112020102010011111
1111101110011111111111111111011100111111111111011011111111111100111010111111111011101010111011011110222111201211222102222222222122020112220aa2221210111110111111
1110010110110011000110111111100101101011110110110011011111111111111110111110111010101111111011111112222212211000110110122222000112111222011ab1121012121101101111
1111110111111111110111111110111111111111111111011111111111111101100110011111101110101110101111111112222200112001111212022022012221210222222ab2010112112110111011
1111101111111111111111111111111000101011001110100111111110111111111111101011111111111010111110110112111001222202012121211222222221201121111ba1122221100011101111
1111011010111100111111111100111011010110101111111110111111111010111001111110100011111110111110101000110022101222202122022221112222001211212aa1011121001110111001
1110101111110111111111111101101111111011011101111111111111111111111111111111111111110111111110111101211011211122122201121120210221012212221aa2112221012111011111
1110001111111111101101111111110111011111001111101111101001101111111111011010100111111111111110101010012112121110210022211022222121220222121ba2221111022111111010
0111101111111111010111110110001111111111010111111110111111111110111111111100111111110111111111011112212201212101211101212222222221020202212ab1122222002101010011
1111100111111001101111111010100011110111111010011111110001111111110111111111111111111001111111100112012201111102200221221202011122011112212bb1211120111111101111
1111100111011111111111011111111110111111101110110101110110111111011001010101001111111011011101111011112221022012120202221100021222112202121ba2111111212001110110
0111011100110111111111101101001111110111000111111111101111111011011111101110011100111111111210221212202222021012102022222222222201012102121ba0112011121111111011
1111111011010001111110111110111001101001110111011111101011101111111111111111111110111110111122101122112221101222200222202210201222011101111bb2022210121110110111
1111111111111111101111111101101101010001111111111111001011010111110111111111011111011111110222211210200022102122120210222211222222210022220bb2101121021111111011
1111011111011011101101111011111100110101101101111010011111111111011011111111111101011100110211021201202220022221212201022112102020022112211bb2221002122101111101
1110110111101110111111111110110011010101011011111111111001111111011111111111111011111111011112212222121201101221211201212111111110111101111aa1101010111101111011
1111111111111110111111101111110110111111111111011111011110011111111111111011111001101111111111221220211001112002011221121011111101100111101aa1111010111010011111
1111111111101111100110111111111111011111111110011110111111111111110111111101011111111010101101201112212102221210110212121110111111110101111aa1111010111111111011
1110111111111111111111110110101111001110101011111111111101011011111111111111111111111011111012121221102222221202212012112110010111111111111aa1111111111110110011
1111011111110111010111110011011111100101111110111111111101111011111011011101011111011111111112212221011102121122212210121011111010111111110aa1111111111111110111
1110111111111111111111110110111111111111111110111100110111110111111010111110010111111001111120011021122111202100221111222111011110101101111aa1111011111111011110
0011111111111111101000111001111111000111011111111111011111110111111110110011111110110111001002212112202122022012211202111111001111111101101aa1111111111001011110
0111111011111100101110100111111001101111111011111110011111111111111100111100101111111011111012121220110220222121211001021011110011111101011aa1111111101101111111
1111111111111110111011111110101101011110111011111111110101110111101111111111110111111101111121122101211211200100022122002111112022102211222ab2110212021101011001
1101011110110010101111111100011111111010111111111111110011110001111110011111111110110110101120020012112211102120202101212201222111111001020ab2111220121010011111
1111111111111110110011111110010111011111011011011011111001110110001110110110111011111101011102121102222111121121210220210102222011221211011ba2220112211111111111
0101111111111111101111111111111110111111111111100110101111111011111111111111001110111111011221111211000221211121111121122211021212211102010ab1110111211111111111
1110110111101101011111101111011111111111111101100111011111110001111110111111111111101110111211122122121022212021122110122202020121001212122bb1112222201111111010
1111011111111110011111111111111111111111100101111111010111011011011111010011011011110101111212210011221111120201122222002002201112111102211bb1011221211010110111
aaaaaaaaaaaaaaaaaaaaaaaaaaaaaaaaaaaaaaaaaaaaaaaaaaaaaaaaaaaaaaaaaaaaaaaaaaaaaaaaaaaaaaaaaaabaababbabaabbaaaaabbbabbbabababaababbabbbabbaaaaaa2001221221111111111
11111111101111111101100111111110111111010001011111011111101111111111100111011111010110011112121000122212200221102012012122211222211220021011b2202121221110011111
01110111111100111111111111111110011011111100122211221222120111010112021221111111111111111011220210111012102211201122121102110212220202222111a2012222121110011001
11111111101011011111110111111111111011111111222010222221212102202222122101111111111010111112002121100210102021202122102111120112221102111212a2122001120110111111
11111111111111111101111111110101110011101111222220121010211100122101222112101111111011111012121212212121201010111221200221212110111222212111b1111212111010110111
1111011111011101111111110111111110111111111112112211212212111002111221122111101111011111111222012112abaabababbaaaaaaaabbbabbbabbbaaabaaababba0111102101011111110
11011111110aaaaaaaaaaaaaaaaaaaaa10101011111110122101221112201011210122210201011111011111111001101112b10210221110212222112102122100001101112122011021011111110111
01110110111a1111111001110111111a11001101111101212100211102102100012222121111100111110101111102122210a21222122001202212212120212101121111121222222000021111110001
01100110110a1111111001010101011a11011111111122112112101211122111022102122110011111101111111211111212a01120212110122021012002212111221221120012212202022221022222
11111011101a0111101101100110111a11111011111121221201222221012012112011221010111111111101111020011201b22222022022121100122101101221101122221211120212220222102222
11111111011a1101110111101111111a11111111111110001002211222022221101212211111111111111011111221210212b10221102201002122211200200102210221212120212122221221222212
11111111110a0111111111101111001a11111111011021012221112222011222221221221211110111111111011112112221b22102011112110111110002202121210221110220122222221110102021
10111111111a1111111111111111011a11111111110112021112211222221122201011222211111111101010011111111011a11001111111001011112220121021101211120022122222202122211221
11111111110a0111110111111110110a11110011110101221012021211122112120121211110111011110111110111111111a11111110111101100110020110012102011101111012200211222021011
00101110110a1001111101101111111a01111111101122121110121012122101212012112201110101101010111101101101a11011101110011111010010121120221121211222122212222001122112
11110110100a1111111111011101110a01111111111122102111001111220211222220122100011001101111111011111110a10011101011011111101101110222011122212021222220022102221122
01111010111a1111001111111111111a01100111011102022202222001211101012211222111110111111111101111110111a11111111001111110112020121111111202011211220021212121212111
11011110110a1111111111111011101a11101110010122102111100121210111222202122201111111101111011111011111a10111111111101101112212102222221221211021012220220201012022
01111111101a0110100111011111111a11011101111010111222002111222101021112212211011111111111110111110111a11101110111010111112220011102100120121201102222221112110102
11111101111a1110111101111010111a11101111011011111121111211112212112222222111011101111111111111101111a10111011111111111111111120221111111201222002222222201002212
11011111111a1111111110111011111a10011110100121211211101001221220002222110211111101111111111111111111a11111011111110110110212110220212011110021121122222202221212
10110001011a1101111111011111110a11110011111120001201011101110201100221012111001011111111111101110111a11100111011111111112121010101111210012212222122221122121111
01101111000a1111111111111111111a11111111101122111221112001221121200102121111111101111011111110101111a11110011111100010112221122021122112120021022222221120221221
10111111111a1111101011111101011a11101110100121201021122222212111211102221211110112102221021011110211a10211012101111111112122201021212102112111200220121100122112
11111111110a1111111111111111101a10111111001112111122221220022010221111121101111202210021021222121202b21011021101111111110111011111111111110111211022020222102110
11111001110a1111010111111011111a11111111111112122211211002022212002201111211110211122222222020012212bbbbbbbbbaaaaaaaaaaaaaaaaaaaaaaaaaaaaaaaaaaabbabbaaaaaabbabb
10111110111a0101111111110110111a01101011111122122202012222121222122210210111101211002022202120122121212011021110111111110111110111101111110110221012212122212110
11011111001a0111011111111001011a10111111111111211121201212202020220222012111010111221221210220210222221112122111111111011011111101111101011111201221001111222111
11110111111a1111100110101111001a11110111001110121022022221122212020220121211010211111102121201120212221212222101110110110111110011110001111110011011122120222121
11111111010a0111011011111101111a11011001111012121020122012222102222120002211111212201221221211212122212121221111010111110101111011110111111101121212211111212112
11111011101a1111110110101111111a11111111011100102220112111221101212212222110111122101201222222222122012221222101100111111101111010001111010011202222101112110201
11111011111a0111110111101011111a10111101011011200210022022221111121110012211011021010212211020022122221120112000001101111111111111111111111100102111120202021111
11111011111a0000011111101111111a01011110111100110110111111111100001011111011111120111102002211011212121112120010111100111111110111101111011111200212111021212211
11111111111a1111111111011101111a11010000111001111111111111001111010110111110111211102210011211222110021121112100110111110111111110111101101111012101121201212212
11101111111a0111111100011111111a10011111111111100111110111111111110111111111010121222120211001122211110022101111101001111111111111111111111001022112101021222221
01111110111a1110111111101101111a11110101111010011111111110111111110011011011110222022221020101000112212211112110101111101111101101110111100011020222121012222211
11111011110a0111101010111111011a01111000101101111001111011111110111101111100111111001010222122210220102222020101101111110011010111011101111111112010011021121222
01111111110a0010111111111110111a11101101111101011111110111111101111111111101111012101101111211101220012121012101111111111101111111101111100101010011110220220201
11111111111a0101111111110111111a00110011111101011111011110101111111111011111111212211021212202012011101220200111011111110011111111111110001110111111111010111110
11101111011a1011011111011111111a10111110110111110111110011111111111011111111111120210001021222012121100121120111011111101111111111111101111101111001111111111111
11101111110a1111111111111011111a00111101010111110000111101111111111101111111110200012211211112011211202020211111111101101010111100111011111110111110111111111101
01011100111a1111100101010111010a10110110111011111111111111111101101111111101110212101020121012120022002211202000111111111001111111111111111111111111101011111111
11111011111a0111111111001010111a00111111110100100111110111111111111011111111100121211210222120021220012120122111111011111110011101011111111111100110111111111111
10111111111a1111111110111101011a11111111111011110111010111111111110111111111011211222122200011211111111022222111111011111011101101101110111011111111110101111101
10111111111a1110111111111101111a11011101101111100111111111111011011100111101011211020120211121111212121011211111111111101110111101111110110111111111111011011001
01111111101a1111011111001111111a11101111101111111101111111111111111011101101100111022122211111201222120110120100101111011011101111001110100111101011010111100111
11100101011a0100111111101101011a01101111111111111111001001011011110111111110101221201011112222221111111122100111010110111111111110111111110110111111111111111111
01111010110a1101101101110111111a10110111011111111111011100010111011001111111111211222111212112122112201120200111001100011111111110101111101111101110110101111111
11111111111a1111010101111011100a01110101101110111111111111111110111101110111101002221202222021220120210210122111011111111111101100111111101011111101000111100111
01111101011a1101111101011110111a11011110111101110110010111111111111111111111111210002221011021112212010122111101111111111111011111111101110111100010111111110011
11111101011a0011111010101110110a11111111110111011011110111000100110111111110111111221212221101000012200221111101011111110111011110011100111111111110111011111111
11111111111a1100000111110111111a11111101011111111111101111101000111110101011101200210222210212222211011011022101101111111011011211021200111112002022201110121010
01011111001a1111101110111111111a11110111011001111111111111111111101110111111111220211222012121021122212121011111111101111011111121121102201211112111211201220101
01101111111a1110111111110111111a11100001111111110010111111111011111011111111101111011111111111101011110111111101111111111111102122012212222101000200112212211111
11111010111a1111011101111110110a11110110111111101111111111111111001111111011111111011110111111100110101111011101101110111111101101122201211022210001212010211111
11111111110a1110111111011101111a10111111111100011111111111011100111111111111111111101111111111111011101110111101111110110111110102112012222222022120212022211000
01111111111a0101111111111111011a11111111111111111111011111110111111111101110111011111111011111111111111111111111010011110111101100122220112112201001221212121111
10001011111a0111111111111101110a11111011110111111010101111011111111111111111111011101101111111111111111011011111110111111101112112222002022222001202221121121111
11111110100a0111101111100111110a11111111101011111111100110111011111111111101011011101111111111011110101111111101111001011101111201012222110211121221201100020101
11111111011a1001101111001011010a11111111111111011101111011111111111111111101011001011110111011010101111010111110111011100110112022112110022121211120120122121101
11010110101a1001001101111111111a10011111011100111111111111111111010101110111111111110111111110101101110110110111011111100011111000101211122122211102212022001011
10110100011a1101110111001110111a11101111111111111111011100111111111101111010011111111111011011101111111000101011111101111110112212221022101021212221121210111100
11110111011a1101101111111001101a11111111111101110110110011111111111011110111111111111110111011011111111111111110111111111100110101000111112110102222221102110111
11111111011a1111001111111111001a10111110111111111011111111111101101111101101101111011111101111111111011011000111110111111111101202121222021010211021212212211100
11111101101a1011111101111110111a01111111111111111111101011011111110111001111111101111011111111111111101011110101111111011111011022111121210020012211121222021010
01011111111a1011110111111110111a00111101111110111111111111011111111011100111111111111111111111111101110111110001111110111111110101222112221222211022122210111111
11101101011a1101111011111111111a01111111110110111110111111111101011111111111111111111110111111111111111110110111110001110111112221011222202021202221110212210111
11111101111a1111110111110111001a11111111101111111111111010111011111111110111011001100111011110011011101101011111111101111111101221211012210022211101212102111111
11000111101a1111101011011101111a11011111aaaaaaaaaaaaaaaaaaaaaaaaaaaaaaaaaaaaaaaaaaaaaaaaaaaaaaaaaaaaaaaaaaaaaaaaaaaaaaaaaaaaaababbbabbabbabaabbbbaabbbaabbaaaaaa
01101111101a1111111011111010110a11111111a11111011111111111101111111111111110111111111111011111110111111111111101011110011111111221102222212211012121222120221111
11111111111a1111101111110111100a11111110a01111011101111111111111111011111111011111111111111111010111111111111111011111111111112111221211101222220211222212221111
10111001111a1111111111011011111a11111111a11001111110111111110111111111101011101111111100111111111111111111100111101100011111100112111201102211221212210102211101
11111011111a1011111011110011111a01111101a01111111011111011101111111111000101011111111111111110001101111111110111101011011111111111110212102001222211210122021111
11010111111a1111111111111111110a11011111a11111101111101111101101111111100111011111101111111011110110101110110111111111111111012222222201021110202200111122121111
00111111111a1111111111111111011a11011110a11110110011111110011110111111111011110111110111011111111111111110110111111011111111101122212121201210221111222122121111
11111111110a1111100111001111111a10110111a11101111101110111101011010000110111111011101111111110111111111111111101111101111110012221211020221020122022122201111101
11001111111a1111010111011111101a11111111a10111111011110111111101100011100111111111110111101010011110111111100111101110011011112021111202101101121022201210201111
11110101011a1011111110110111111a11111111a11011111111101111110111111011111111111111110111111111001111111111010001110111111111111120211211202112212210210202221011
11101110111a0111111110111101011a01101110a11111010011110111111111111101011101011111111111011111100111110101110111110111110111101111111021221222222222012020021011
11111111111a0111110110110001111a11110111a01111111111111111111100011111111000111111110111100111111110011001101111100111111111110211002212020001202212111122121111
11011011101a1111111111111111111a11111111a01101110111111111110100111111011111111111111111011111111111111111101101110101111011111011112201222011012201122112021111
10111011011a1011101010111011111a11101111a11101111111110111111101111110111111111111111011100111011111011111111101111111011101011011111111111111111111111011111111
11111111101a0011011111111011111a11111100a11101110111111111111110111010101111110111110110111001010110111111101111001111111110111111111101111101110110111110111111
11111011101a1111101111111111111a11101111a10111111011011110111011111110011011101111001110111110101101101111100111111101110111110111111011110011111011101111111110
11011111111a1110111001111101111a11111111a11111100101101111110100111101111111111101111111110111111111111010111101110101111111101111101111111001101111111111111101
11101111101a1101111111111011111a11111111a10111111101110101111111111001101011101111111111111110111110111111111011111110111111111111111111111111110101111101111101
