(14,41)
(23,142)
(33,26)
(65,45)
(87,64)
(33,44)
(38,9)
(100,68)
(69,69)
(32,8)
110110111011111111111110011011011110111111111111101111111101111110111101111111111111111111aa101110110011101101111110111110111111110a011011111111111111a101111111
111111011111111111111110111111100110111111100111101111011111111101010111011001111111111111aa111111110101111111010111111011111111111a111111111111011110a100100111
111110101101101110111111111111111111110111110111101110111111111001110001111111111111101111aa111011011111011111011101101110110111111a110011111101111101a110111111
111111111111111110111111111111011101111011110111111011110111110011101111111110110101111110aa111111010011111010111111101111111111110a001111100011100101a111111111
001111101111111100111111110101111101101101111110111111110001111111011010101111100111111111aa111110111111111110111111101111111100110a011011110111111111a111101111
1111010111110010111aaaaaaaaaaaaaaaaaaaaaaaaaaaaaaaaaaaaaaaaa111111110011111100000111111111aa111111101111111111111111111111111111101a011111111111110111a111110111
1110111111110111111a110011111111011101101111111111111011111a111111111111111011111111011111aa110001111111101111111111111011111111111a011111111100101111a111111101
1110101100111110111a100111111100111111100111110111101111111a111111110111110111001110101111aa011101111011111011111111000111111111111a111111011111110010a101111011
1111111110101111111a101011110110110111011111111011101111011a100011011010111110110011011011aa011100111111111111111011011011011110111a111111110111101111a111111101
1111111111000101111a111101101101111001111100111110111111111a111011011111111101111011111111aa101110110001111011111111101101110111001a111100111111111111a111101011
1110110111110011101a111011101100111111110111011011110111011a111011111111111100001111111111aa001011101111111011011101101110111111101a110111101111110010a010111011
0110111110111111111a111110111111111111110110111111110110011a110111110111101010101111101111aa111011111001111101111011011110101101100a111111001100111111a111101111
1111111111111111101a111001111111111110110110111011111010111a111111111111000110111110111101aa110111101111011101110011111101110001010a111101111011111101a110101111
0110111000111011111a101001111111100111010111011101111101110a110111101111011111111101111111aa111110100101111011111111010110110111111a111111111111111110a111011111
0111110101110110111a100111111111111111101101111111110111111a111111111000111110111101101101aa101111111111111111111101111110101111111a111100111101111110a001111111
1110110111011111011a101111101010111110100111111110101111110a111010111111101101100011111111aa111111111110110100011111111011111111111a101011111011111011a011101011
1101011111111101111a011110110011111101111101010010110011111a111011111001111110101110111111aa111101001110111101101111111100111111111a101111010011101110a111111111
2100211110122020021b020110111111001110111111111100101111111a101101011101111111111101100111aa011111111101111111111101111110111101011a111101110001110111a110010111
1200110222222222221b110011111222212002201101120121221112212a111111011101111101111111111111aa111111111111011011101111111111011101111a010111000011111111a110110111
2202121220022211222b021212122222101212201010121112111011120a111111111010111110111110110010aa111100111101101110111100111111011111111a101101101100111111a111001110
1102012120002222222b212111122022222212212021221211201120222a110111111110111001111111011100aa010111111111101111111111111011011101010a111111010111110111a111111111
2221102210110222122b101121211120221022220002121012101220222a011100101111111110111110011101aa110111111111111111110111111101111101111a010111011111011111a101111101
2122220012222022221a021112002021102001121210212222112122221a110100111111011111100111111111aa101111110111010101011111101111111111111a111100011101111111a110101111
2221112001000222221b021210211222212120200121201112212221121a111111111111110111001111111110aa111111111100011100010101110101111100110a111111010111111110a111111011
2122222101200202222b222021220122021120222212022120021110011a111111111011110101111010111101aa011111110111100111101011100000111101011a011111011001111001a111110111
aabbbbbbababbbbbbbbb221221011012012222212212112222212112201a111011111101011111011101111110aa101100111110011101111011101011010111111a111111110111111101a111101111
21110122222220202122222212212120222122220121211122011112001a011011111011111111111111111111aa101110111111111111111111101010101111110a001111111111100111a111011111
21110022221220222202221021102222222012112011202010211111221a111111111011110111011111110111aa111100011011111111111010101111111110111a110001110111101111a011111011
22122222021020222212222022212202220210202222022100112222211a111111010111111110011001111010aa101001011011110011110111111111111111111a111111111101101111a011111111
12111022222122022222221210112222112222211101222120121212210a110101101111011111111101111110aa111110110011011110111011111111111111101a011111111110111111a111110010
20212222200222212221120201120222122222122121220111210210110a110111111100010111111111000111aa111011100110111011110111010111111111111a111111001011110010a101111111
22220202122211222202202012222121201122112222111122221221100a101011100111100101111111111000aa101111111111111111111111110011111101010a111111101111111111a111011100
12222221200200022222022121122002021122222111122201221220112a110111011111101111111101110111aa101011111010111110011011111111111111011a111111111011111111a111111111
12221212202222222212221200101201020022022211011002102211202a010011111111111111111110111010aa011111111110111111011011111011111111011a111101111110111111a100110101
20222220122220222202202210221220022222222122102121211211222a111001111111111100111111111111aa011110111011101111011111111111101001111a111111110111101011a111111111
02120012112222220222222022212211221222012220021111212202210a111111111111111111111000111111aa111110110111011111111011111111101111111a111111110010101000a111011101
02120021200222122121222202022102021222022112201022012222012a111111111111111111111011111111aa001111111011111111111011011111111111101a110110111101011111a011111011
02222200222222222222222112221212022222202111111221211102210a101101111101111111011111011110aa010111010111010000010110011111111110010a110101111111111111a111111011
22222122012122202222202201211212200121210121211012221202202a101111111100111111101111111110aa111011111111110111111111101111111101111a011111110101111110a111111011
20022222020022022202222212122212020211222201121021111210211a111111111111111111101111111111aa111010111001010111011111111111111111111a011101011001111101a111111111
12010202222120222220222121221220102200202122222122110012011a111111101011111110101001110011aa111111111110011011010101111110110111111a110110111011111111a110100111
12222022021222222022222210211220220212220211000112211222201a111111111111010101111111001111aa111101110111111111111010101010110111011a011010111111010111a110111111
02022022222222222200020101102020022110222012212221222121220a111111011001100110111111100101aa111110111011101100111011111011111000111a111110111111101100a110111111
22221102220122222222222221110022221120221210201122122222012a111101111111111111111111111111aa101111111111001111111111001101111111111a111010111111111011a011111011
01220222211222221122200021111202222020221102220112211002121a111110011111111111110011111111aa110010011101111110001111111111110101101a111101111101011111a111111011
20221222021222022220202201122022221212102222102221212022120a101111111111110111001010110001aa011110111111101111101111101001111111011a111011011100111111a011111111
22210210222102222220112221022210021122112111212022121210001a111111011111111111111001000110aa111010111111111111111111111101101101111a101011100111101111a110111011
22101020201022222222222201112222202212212210121121121112112a111011111011110111001111111111aa011111110111111101111101111110111111111a111111111100101110a011111111
11222112121101210110202211111110111011011111111110101111111a111111111111000111110101111010aa111110111111011111011111110111111100111a110111110110011110a111111111
22121022202122212021121211111111011111111111110101111111011a111101111101001111111111101011aa111111110111111011011110011111101111111a010111111111111111a111101111
11212221101110002211101111101111122120001112012122221102010a101111101011111101110111111110aa111011101111111111111111101101111111000a011111111101111101a111011011
20120201122120222212120210101121102221121112111021220101112a100111111101111111110111011010aa111111111010101111011111010101111001111a111111110110111111a111101110
10011111101210021001102110111120211212212120221201022212102b011100111111100111101111100111aa111110111101111101100111111110110111111a101100111110101111a010101111
01111111111111111111111101101121221101211120111122221102110a101111110111111011110111111010aa111111111101010101110110111111001101111a101110111001111101a110101111
10001100110110011011110101011121022102122022121221112112201b021021111200122222221211111111aa111110111111110011110111111111111100111a111111101111111111a110101011
11111011111010111011111111110111121101221012211110211202121b222221112121212221211012011111aa111111011110101100111111111110110111111a101111011111111011a011111111
11001111111110111111001110101120221021221221212222212222212b222001221011222021111122101110aa111111111000110111111100101110110011111a111111111111010101a111111101
10111011111111101111111111111001122112111102101211122222222b120222022022002021012212110111aa111111101111110111111111111111101011101a101110111010111111a111011011
01100010110111111111101110001111112122002222121111111112122b011210212011220102220112101011aa111111110011101011100111101111111010111a111011111111111110a111111110
11111111111011111111111111111111102111200011211220100222221b212221021121121022011122111101aa101110111000001101111011011011111111110a111101111111110111a110111101
11011101010111111110111111110111112201022012122222201102211a110011212111202101010110110110aa111111011111011111010110011111110100001a011111110111010111a111111001
01111011111111111011101111111012102221212111120120221020202b121112201201201022221120011110aa111111111111111111111011111101110111111a111111111111111111a011111111
00111111000111101111001110111112120002211111022022112221121b011121002211100112202011111010aa011001111111110111011011101111001110011a101010111111111111a111011011
11111001110011111111110111111122012201112112212211121012121b112001102222021112122210111110aa110110111111101000111111111111011111011a110011111111111011a011110101
10111111110010111110110111111111212220021111002111222202122b021200110011122112121011110111aa011100011111010011110110110011111111100a111111111111011111a011111111
110110110011111111011110011111210222220abaabaaabaabbbbbabbba111122101221122120102212101110aa011111111111111101111111100111111111111a101110111110111011a111111111
111111111011111111111111011111221222112a10222212011121220122101121201112221001021202110101aa111101111010111111110111111111111111111a111011110111111111a011110011
011111001011111111011111111111110121122b11000122012010002122202112021212210222211101110101aa011101001011101111011111011111111110110a111111111111111111a111111111
110101111001111011111011111111220211121a11112201121120202220112102120221220221222021111111aa111110100111011111111111111111111111111a111111011111101110a111110111
111111111111111111111110111101121210222b21222220101120222212112102110121211121211122111011aa111011011010111000100111111111111101101a101011111101111111a100111111
111101111101010110101010110111212110212b12211211220202102012122122012110212202111202110111aa010111111010111100101011101111111111001a111101111110101011a111111111
111111011111110101110011111111222121222b12212122200111022012222110221101000121112212111110aa111011111111011110111001111101101111111a111111011010110110a001011111
010111111111111011111101001101100112222b22220211021222011022221222200020220212221021101111aa110011111111110111111111110011101001111a011111111111100111a111111101
011111111011111011111110011111122111110b10121212221002012202222201220002220222111012011110aa111111111100111110110111111111100110001a111110110010111011a111111111
111111111110111111111101110111202122211b11221221122202022121220222101020022220222012111111aa101111011101101111111110111110001001111a000111111111101111a011011011
011111101111111011110111111110110212220b21222122222222222022022202211122212221210100111111aa111111010101101011111111110111111111010a111111111111101111a011011111
111101111011111111111111011111021221011a02112101022102202222222222112222211022221122111111aa111111110111111101111111101111111011001a111011110111111110a110011100
110011111111111001110010011101212201002a20220221022122220222212212222222222222211202011111aa111101011111110111111110111001011011111a111011011111111110a110111111
110101111001110110111111101100110021122b12012201200212222222222221222212222222022212111111aa110001010011111011100111111111101110111a011111111111100111a110110011
100111011111101110001110111011212010222b21222111212210022220222222220122222202221020111100aaaaaaaaaaaaaaaaaaaaaaaaaaaaaaaaaaaaaaaaaa110101111110111111a111111111
001011111100001111101111011111101101111a00010111021201220020220222101221221201212210111111a11111111000110111111011101111111011011111100111011110110111a111111111
011110111111110001111111110100011110111a11111001111112222222222212202112210221122122110111a11000111111011111111011011010111111111111011111101111111111a001111001
111111111111101111110111110111111110011a01011110012201212112002122222222222122222112111110a01111111111111001111101100111111111111100111111010111111110a011100101
110010111110111111001111011001110100110a01111110012012020102012222222122001002212100111111a01110111111111110111111110011100111111111111110110101101011a110111111
111010101111110110111111111110111001111a01111110000012121220212011121011212110111101110111a01111101111111111111111111100111111110111111111011111101111a111100111
aaaaaaaaaaaaaaaaaaaaaaaaaaaaaaaaaaaaaaaa01110111121012220120122220212121222222121221110101a10111110111111101101011111101101111111110111111011111110111a111111010
010101110111011011111110011111101011110101110111022012222012212122212012222220222101111111a11111110111111011111111111110110111011011111001110110111011a111111111
110001001111111111111101111111111101111111111110001110202212102021221122012102202010111011a10101010110111011111110011110101101110111111111111101001111a101011111
111111111111011111111111111110111111111111111101110222222222122202212212222222212211011011a11011111101111111101111111110111110011111101011111011111111a011011110
011101111111111101111111110101101011110101111111112202211122222220221022122001011200111111a01101111110111111101111110111111111111011011101001111111111a101111011
111111111011101110111101110101111111101111110111122021222212211221112222122022210211101110a11110101111111111111101011100101111111111111111111111110111a111111011
111110111111111111001111111111111111111111111101121112212202222221221012222200020020011110a01011110111111111111110011110011111111011111111111011110110a011111111
111111110010110011100100110111110111110111111101111100212020120120022222211211222110111111a01111111111111111111111110111111101100011111010110111011110a110110111
111001111111100100111110111111010110010101111110100110021220220022221200212220222211100111a10111111110111111110111111111011111111111111111101100101111a111101011
111111111111111111111101111111011111101101111111122202222222022112022222122020111111111111a10101101110111111101111011110111111011101111111101111110110a111111100
001111111111011110011111111111111110111111011111112102212211212222222222122222220011110111a10101111111101101111110111011011111011110001011111110111111a111101111
111110101011111010111101110011111111011111110110112010122222202220222112211222222221110011a11101111111111101111111100111011010111011111111101111010111a111111110
111111111000110111010011111111011110111110011011111212020222210020022221221012120011101111a10111111110111111100011110111101110111111111001111111111110a111101110
110111111111111111111111111111111111111110111111112122022002212220022222022022112111001111a11111111111101011110111101111111111111100111111111111101101a111111110
011111111101011110111010111011110111111011111111121111222012020200222220022202121021111111aaaaaaaaaaaaaaaaaaaaaaaaaaaaaaaaaaaaaaaaaaaaaaaaaaaaaaaaaaaaa100101110
1111101101111101011110111011110111101111111010111212212112022222122222222222222210201111001110111101100111101111111110011100001010111011111111111110111111010111
1111111111011011111111100111111110001111111111010122121221202222122210220222222022211100111001111101111101011111111111011111111111000101111110111001011111111110
1111100111110110100111111011101111111111111111011101121222111212022011112102212002011111111110111101111010111111111101111011111111101111011111110111111111110111
0111011111111111110111011100101111111010111111111011112211011220022212111110011021211100111101011111111111111010111111111011111110111101011110101111101111001111
1011110101111011111101111100110110111111111111101111112110200111220120010212012211211111111111111111111110111111101111111111101100011111111001111111011110011111
1111111011111111111110111111111111111110111110111101120202112021012200120201222102211011111111111110101111110011111111111111111111010011111111111111111111111111
1111101110111111110110111111110011111111111101111110111211121122002102221112121202101111111101000111111001111110111111110111100111111111111101111111111101111111
1011110111111011010011111111111111110101010111010001122211222210221202202120122120211111011111111111111110100111110011110001111111111111111111011111110100101101
1111100111110011110011110111111001111100011110011011121122121112211201221211221211110111111011011100110101111110010101111111111110111101101010111111110110111111
1111101111111111101111101111111111110100010111101111112122221222222120101212011210201110100110101111110111011111111111111111111111101111111011110101011111111111
1101111111111111111111111111111111111111111001111101122222012112101112222221212022111111011101111111111111111001111111111110111110111111111111110111111111101111
0010111101111011110010011111111111111111110111111110120112202112221212201210211221211111001010110100111111111111111101111101101011110111011100111111111010111111
1111101111011101011110111101011111111111011111111101102001211122100221111212121112111111101101111011111111011111111111110111111101111111101110011111011111111111
1011111001111011010110111111101111100111110111111111122212002221011202102001222121111111010001111111111111011110101101001111110111110101011111101101011011111011
1011111111001110111110101110101111111110101011111111112120002122202112011211220022110000111011111001111110101111101111111110011110010011111100111101011100101101
aaaaaaaaaaaaaaaaaaaaaaaaaaaaaaaaaaaaaaaaaaaaaaaaaaaaaaaaaaaaaaaaaaaaaaaaaaaaaaaaaaaaaaaaaaaaaaaaaaaaaaaaaaaaaaaaaaaaaaaaaaaaaaaaaaaaaaaaaaaaaaaaaaaaaaaaaaaaaaaa
1011101111111111111001110111111111111111111111111101111001111101011111111111111101111111111111110010111111111011111010110011011101110110111111111101100100010110
1101011111001101101101110100001110110101110111110111010110111111111010001110111111100111011110111111111001111101101111111111111111111110111011111011111011111111
1101111111011111110001111111101011111011111111101010111110011111111011110001111111111101111110010111111011110111111111011101111111111011111100011111101011111101
1111101111110101011110011111110111111100101101111111111011100111111110111111011111110111110100111111111111100111111111100011101110011101111101110111111110111011
