(108,141)
(4,8)
(96,13)
(47,107)
(34,57)
(91,0)
(118,149)
(107,9)
(112,15)
(89,114)
11111010100101110110111111111111110101101110111101011111111a01011010110111101111a1011111110111111111111100111110011111111111111111111011100001111101110110111111
11111111110111001111111011111011101111101111111011111010111a11111110110110111111a1110111111101111011111111110111111011011100111110100111010110111110111110111011
01110101111110101111111011111110111000111101111111111101001a01111111111111101111a1101111011111111111111011011011011111111001101100111111111111111111111110111111
01101101110011111111110100110111101111101111011111101111010a11111011100111111111a1111111101111111111111111101101111111110110101101111111101111110111111110011110
11110110111111101111111111011111111111111011111111001111111a10101101101111011111a1111111111111111111111001110111111111111101111011101110111110111111011110011011
11101111001111100111111110101111111011110101111111111110111a11111101100111101111a0111111111111101111011111110111011111111111001111101111110101111110111111111111
11111111111111111101111010111011100111111011110101111100111a11101111111111111101a1111111111111111101111001011111111101110111011101110001111111111001111011111111
11100111111101111111011111111111111101111110100111111111011a11011110011111111011a1101111111101111111111110011100100111101110011101111111101011110101101001101101
11011011111011011111001110110111011111011111111101111111111a11111111011111011111a0111111110111111110111111101111011111011111111100101011111111101101101111011111
01110111111011111111101111111110111111011111111111101011111a10111010001110111111a0011010111111111111111011111111101111110111111111000100011110000111011111011111
11101111111101001001110110101100100111100101111011110101101a11110110111010011110a1111011110111111111111110111011101111101111011111111011110101111011000111111101
11101011110111111101111111111110111011101011011111111111111a01111101111101101111a1101101111111110100100111111111111011011111110111111011111011111010111011111110
10111101011111101101110101111010111111111010111101111111111a11011111011011110101a0111111101110111111111111011111111010111011111101111111111111101111101110010111
11111111111100111111011111011111111011011111111111111110110a11010111111111101111a1111011110010111011111111101111111110111101110111110111111011111101110111111111
11110001111111111110111111111111111111111101000111110110111a11011101101111111110a1111101011011111011111111111111101111111111001111110111011111111111011111101011
01100011110111110011101100011111111111111111011111011011111a11111110111111110011a1111111111111100111011101111111011110111110111101101111110111111111011111111101
10111111111111011101111101011111001101111101111111110111111a01110110111110101001a1111100111111101110111110111111101111111110111111111111111101111100011011110111
11110111111111101111111111111111111110111111101111111111111a11111111101111111101a1110011111111011111100001111101111110101101111111111111111111011011111011101110
01111111011101110111111110001011111111110101111010111111101a01110011111111111111a1011001001110111111111111111111111111111111110001111100111011111100111111111111
01111111111110101111111111011110110111111121102021122211002a11121112100211111111a1111011101111110101101110111111111011110111111101011110011111010111110100111011
01011111111101111010111001111111110111111121221020021221111b01112200202111101101a1111111111111111110111111111011111101010111111110011111111111011011111111111111
01111110111101101011111111111101110010110111222221102211212b01001221012201100101a1100101011111111111010111111111111111111111111111111011111110110011101101111011
11011011101110111100011111101111110001011001220222111111201b11120211220211111001a1111101111111111111111111001111111110111001110111100111111111111111110111111011
11101111110111111111111111111111111101011112211212110122110b21111222110011011111a0111001111111111101111111110111110110111110011111111111101111111111100111111111
11001111111111110011101101111101111011100122212122112120112a11101202111211111100a0101100110111111111110111101111111111101110100011111111101111101011011010111111
11110111111001110111110101101011111111111120111221202022010a11112101211000100111a1111111111111110110111101111111111001011011111001111111111111011111111110111101
11101111011101111011011111101111111111111011122122212122121a11122101221111111011a0110101110011010111110110111111110101111100011111110101111111111111111100111101
11111011111111111111111111110111011111111111111102200200121b21112022222111111111a1111111111110011111111111111111111111110111110111111111111101110101011111111111
11101100111111111111111111001110111111011111222122010012201b22220211010011111111a0111101101101111000111111110011110111111111110101110010011111101001101001111111
11101101100011011111101011110111111111111110122211220102102b12211210222100111001a1111100110011111111111101111101111111101101111111111101111001011011111111111111
10101111101110010111100101101001101111101111100212122201120a22001021212101111111a1111111111101111111111110011111110011111000111001111111110111011111111111111110
11111111111101101111001011001111111100111120222212222222200b10122021012210011111a1110100111111101101111001100111110111011100011111101001111011000111111110110111
11111110011011100111101111011011111101101122122022022011121b21110112120210111111a1111101011101222122222112212110022121200211011111111011111011011111110110111111
01011111111101110111011111011111111011110112222202021010121b10121122220111011111a1111110111102122012222201211122212110210101011111111111111110011111101110111011
11111111111111101100011111111111111110101120111212122011211a12222010021110110101a1011011111101020011021202112221122222110211011110111110111111111101010100111111
11111001111111111111110111111111110100011120112121221111000b11122011202111010110a0111011100122102110121212011100121201000111111111011110111111111111110111110111
11011110011011011111110111111111111111111111200010201120122b11102121211201001111a1111111111111122221121220001221020202120111000011111111111111101111110111011101
10111010110101010111111110111011111011010021000211221212211a10111201121110111111a1111011111120020121112221111212120112122000110111110111011111100111101111111101
01111111010111111011111001111000101111110121211221012122220a12222212111101011111a1011111101110122122222021210111122022221211111111111111111111111111111111111111
11110011101111011101111011111101111111111120012212120111222b02210212122210111111a1111010111112222200211211022112122111112110111111111001111011111101011111001111
01111110111011100001111111011110101111001111201201122220201b12122200221111111111a0111111001122110221210221122122111122211110110101111111111111100111111110111111
11111111111101111011111111101111110111111120112211112102011a10211122211111101111a1011111111101122220222121220212212211222111111111111011101111111110111110111110
11110110110101110111111111011111010111011122222220212022120b21120212022111110111a1011011111101121220121012112212000120111111011111001101111111111101111111111100
11111110111111111111101011011110101101110121212112101111110a22022202022011111010a0101111111020121121220111221211202112122111111111111110011111100111111111110111
11111101111111111101111111110111110011100122012210122221201a21221001100111110111a1111110110101010111012000221121202012211101011111011111100110111101011011001110
11011111111111111011111101011101111111101100102121221211112b22111212211201101101aaaaaaaaaaaabaaaabbaabaabaaabbabaaabababbaaaaaaaaaaaaaaaaaaaaaaaaaaaaaaaaaaaaaaa
00110011111101111111011111100111011111111022220122101112012b0120212221111111011110111111111120222220001222101210102110210111110110111111011101110001111010111111
11111111101111111111111111111111111011111111212220211020202b2220121101200111111011111111011120022110102101121121122200222211110111111111101101100111110011111100
11111011111001101111110111100011110101111122122211111122212b2210121221111101011111101111111021221122121222122222012112102011011111111011001111111100111110111111
aaaaaaaaaaaaaaaaaaaaaaaaaaaaaaaaaaaaaaaaaaaaaaaaaaaaaaaaaaaa0101110011011111111101111111111101222201100001201202100201212211111111111110100101111111010110111110
0110111000111111111111111111111111111110011111111111111011111101111010011011111011111101101110021012011120222211122222121111111111011111011101101111111111111011
1101111111111111111011111111111111010111011111011111011001011011101101100110111110101111111121111202221200222221120021201201101111111101100100111101110010101110
0101101011011111011011111111110111110110111110111011101111111111101111011111111011111111011112211012211002202221121022211101011110110111100111110111011111011111
1000111111111010111110111101000110001101111110011111011111101110011111111111111111111111001112012110102101002221022101102111011111111111100111111111110011111111
1101100101111011111111111010111011111101011111111111100111111111111111111001111111111001101022112212222212202020211010112101111111010111111111110101111110011111
1111111111111111010011101011111001111111111101000111111010111111111111111111111101111111101111122211112020022012221200111211101101111111001010110110111111110111
11111010110101101111aaaaaaaaaaaaaaaaaaaaa11101110111111101011111110110101111111111111111111121212220221122000101011120220111111111111010111110011101011011111111
01111011111000111111a1110011110101111111a11111111010110110111111111111111111111011111111011121211221102201221200020220122211111011111111111110100111101110111011
11111110001001001110a1111111111110010011a11111011111010111100111011011111111111101111010010111101122121111201212222122011111101011111111111101010111101100111011
11111010111111110111a1011010110111111111a11111111111110110011101011111101111011111111011111122011211010202011122011122112101111010111111001111111110010111111101
11111110000111101111a1100110111101111111a11111111111111111111110111111011011111111111011111012101101211222121222011222200211111101110110111100111111111110110111
11101111101111100111a1011111111111111111a11111101111111111111111111111111110111111111111101002021112221101022111212222200111111111111111111011111101001011111111
11011101111111110111a1010111101111111110a10011111111111101100110111101111111101111111100111111110110111111110101000101111111110111011110001101111001011111010110
01111111111101111111a1111011111111111111a10111111111101111111101111111101111111111111110111111111011111111110111101111011011111111111101010111011111000111001100
11111101111011101111a1111111011111111111a01111111101111101001111111111100111111110101101111010111101111101110111110101111111010111011010011111100110111011111101
11111101101101111111a1111111100110010101a11111010010101110111111101111111111011111111001111111111101111111111111111111111111110101111101111011011111011101111111
11111011110111111111a1111011001101111111a10111110101011101111111111111111111111101011110111111111111111101111111111010111111111111111101011110111111100011110111
00111111110111101010a1101101111110101100a00001111111111110111111110111111111111111010010101111111111111111111101011110111111111111111111111101111111101101011111
11001101010101111011a1110111111101010110a11001010101110110101111001101101111111111111111111001111111111111101111111110111101011101111111111110111111111110111111
10111101110101111111a1111111111111101100a11111111011111101001111110110110111101111111111111111111111011111110111111100111101101011110111011110111011001111011101
01101111011110111111a1111111101111111101a11100111111001010010111111101111111111111101110110111111101111111111110001111101111111101111111101100111111111101011111
11100101110111111111a1110111111101111111a11111111111111111101111111110111111101111111111111011011111111100010110110111001110111011111001111111110111110101010111
11011111110110101101a0111111111011111110a10011100111101111101111111101101111011010111100101101111111111111111111100111111110011111011111111111011111111101101110
00111111111111011011a1111110100110110111a01111111101111101101011111010111101111110111110111111011010111111111110111111111111110111111101011110111111011111110100
11111011111111111111a1111111111110110111a11111111100110111110101101111110101111111101111011100111112221002111100222121212220012211111111100001110001111101111101
01101110101111111111a1101011111011111101a00111111111101111010111111111111111111111110111111111111110110211110212111011111222111221100110111100100110110101011111
11202112202212211111a1111100111100101111aaaaaaaaaaaaaaaaaaaaaaaaaaaaaaaaaaaaaaaaaaaaaaaaaaaaaaaaaaababbabbbbbbbabbaaaabaabaabbbaaaaaaaaaaaaaaaaaaaaaaaaaaaaaaaaa
12100111201111211111a1100010111011111110110111111011111111101111111111011001101111110101110111110112102121222111121212211211022121011001111110110111111111101111
12201111202022200111a1111110010111111111001100111111101011111101011011011011111111111111011111111110101111112021201200212111001121101011111110011110111110111111
21210220111121210111a1111101111010110111011111111000111110011111101011110111101111111111111111011111122211122111212111021101122101101011111101011111001111111011
01101111100112110111a0111111111111111111111011001111110111101111111111001111111111aaaaaaaaaaaaaaaaabbaaabbbabbaabababbbababaaabbaaaaaaaaaaaaaaaaaaaaaaaaaaaaaaaa
20222222222222210020b1110222111111111111111101111111001110111110101111111101011110a10111011101110110000012210001121111212112222101111110110111111111101111110110
02022201022222202121b1202022111111001110000111111101111101101111111111011111110111a01111101111111101002121001211221212221212210111011011111011110110111011111001
12202222210122202001a1211101011111110110110111111111111101111111111101111111101111a11111101011111112211221121122001211211110221221111110111111111100111111111111
22202002101202020011a2212120010110111011111101111010101111011101110111111000111110a11111111111101102002202222212020002221201221121101110110101010111111111111110
10222112212001220021a1102101111111101111111111111111111111110111110110111111111101a11101111110111102121012111221201001112120121121101111111000110011111011101110
02022000211200121200b0211021011110101111110111100111011111111111111101111111111111a11101111101101110110012211111011122022201110101001011111011011111111111111111
20220222222202022222b2221120111011100111111101111011111011111111101111111111111111a11110011111111112010122111222121212202122211211111001111111110111111111110111
22222112222222222112b2021111111111111101111111011111011011111111111110001111111111a11111111111110112201221102121212221202002022211111110111111110110101101111111
22220111222222202122b1202120110111110111111001101011010100111111111110111111111110a01111111111100010001021011112210221121000011021111111101011111110111110101011
22200102022220020210a2221112110110111110111111101001111111111001011111111111101111a11110111101101100011202211221022022010220112201011111111101111111111111111111
12111002210121111022a2221020111110111111101111110111101111111111101111111110011111a01010111000100112022110121100112211110012120110001111100111101111111001111111
22221220022122222212b2220222111011111111111110111111110111111100101110111111101011a01011111111111111102111220212221212100210121211111111111101111111101111111111
22222022220120222022b2200212111110111111111101110111101001011111111111111011101111a11111111101111110122220210121220220201021122201101110111111101110011011111111
20222222221222222222b0221210111101011110101111010001111100101110111100111111101110a11001101111111111222102201121211220102222221121111111100101111110111101111101
22022221002120022022a2220121101010111111111010111111001010110101111110111110111111a10100011111011111212222221102201201121222012121110110011111111111110111101010
22122122212221212222b0021121101111111101111111111111111111101111101100011011011110a11111111011110111220212221002011112112201012120111111111100111111111111110110
02220202202221222212a1222021221110011011111011111111011111111101010111111101010110a10111111111111110111001221220012122211212201211011111011011011111111111111111
02222022202102222220b2201022120011111111100111111111011111011111111110111111111011a11111111011111111211112010210112100220112012110110111101111111111111111011011
22202222020222022222b2201221121111101111010111101111111110111101001011101111111001a11110111011101112022111012100200211211211122111011111101011111101101111011000
02022122222222202202b0121222221111111111100101101111110110111111011101111011011111aaaaaaaaaaaaaaaaababbaaaabbaababaaaaabaab1222020111011111110110110111101110111
21221222202222222222b22200121210100111011101111101111111111111111111111001111111111111110110001111111210012202112210101120b1122111110110111011111110111111111111
02022200002201202220b22201101011111111111110111001111100101111110110101011110110101110111101111111121020222201120011221100a1120100101011011110111111011011111110
22222222222222222222b22212120200110111111111111111111011011111011111111101111011111101110101111111111101111110210100121022a2221201001122212221212012121122221110
22222022220220202220b22221220011101111011111111011111011111011111111110111111011011011111111111110111011111101111110111101a1010110011122222112112111211212211121
00222222222221022220b12211221111111111111111011010011011101111001111111111111111111111111010111101111011111111011011111110a1011111111122121122211202122220102221
02212220122022212010b22222221111011101111100011110101111011111111111011001111111111001111110110111011111111111111111111101a1111011111010122212122112212212110220
22211002222222202220a20022211111111111111111011011101110110011111111100111111011111011010111111111011101100111111111101011a1111101111121110122001020210112212022
22122222221220222222a22202221011011111111110010011111111111101110110110010111111111011111111111101111111011111101111110111a1111111111011011201112012111021221101
22022221222221222120a22210002111111011101111010101111111110011110110101011110111111111111111110011110110010101111001111111a1111110111111122112112122112110221112
22020220222122222222b11222221211111111111101111111111101111101111111011111111111111111100100111111111001111110011111110111a1111101011111122221100112010121101221
22020020222222202220b01220202201111110111011011011011101111111100101111011111011111110011100111111101111100111111101001111a1111111011021111022212120011111012101
22022221220211011220b12221021211111111111111110111111111111011001111111101110111101101001111100110101111110011100111111010a1111111011012000221201201102222121020
22100122222111222221b22220102101011001101111111011011110111111111010101111001111111111110110111111001011110111111111111111a1110011011122022011202222220222011111
21220022222220222112b02222001010111010111111111111011111111111111111010011011111111011111111101111101000011111111011111110a1111110101101221121022102201121211112
00022212222202222222b21010122211100011101111111101111111111111100101111111111110111011101011011110111111011111101011111110a1111011111122220112110212101012120222
22222222212202222202b12021122011111111111111110011101111111010101111011101111001110111111100101101111111010111001101111101a0111101111112020210111112221222222222
22212221202212202222a02110011111110011011101111111111111111110110111011111111111111111101101110101111111101010110111101110a0110101101120111222022110222021211020
21212012222121012121b21110001211101011011111101111111111111111111111111001111101011111111111101111101101011110110101010111a1111110111121120121121111222122022222
21122221221122022202b12202202111001011001111110010011111101111111111011011111110110111011111111111111010111111111001110101a1111001111021111122212201121021202120
