(76,157)
(72,3)
(5,120)
(54,124)
(6,127)
(52,143)
(53,43)
(30,59)
(112,21)
(79,85)
1111111111111111111101111011111101111110111111110111011110111111001101110101111a1111011111111110100101111011b212011001212121112020121211101112111101110111011a11
1111111111111011111111111111111101101101111111111000101111111111111110101101111a1111101110111011110101111102b202222122120210021201222222112211010101111010111a01
1111111101101111111111111111110111011111001111001111111101111111111111011111011a1100111110111111111111110111a021020122212222022021122122122212111111011100111a11
1101111111001100101111111111001101111111110111111110101111110010110111111111111a1111110011011101111111111111b022222220222022020222022221101121011111111111111a11
1111110111111000111110111111101111111111111111111111010110101011111101110111111a1111111101111111101011111122b212212201222011222212222001112112101101101110111a11
1111111111111111111101111111111111111011010111011111010001111101111110111010011a1111101111111111111111011222a021220212122200222202221212121212100111111111111a01
1111011101111111111111111111111110110111110110110111011111111111110101111001111a0111011011111111011011110101b120212112121222202212022022222111101111101011111a11
1011111111111111010111111111111011111101101111011111111110011111111011101101111a1011111011111011111011001120b111222220222022221020221222220122011111001110110a11
0111111100111011111111101101010111110111101111111111111110111111010111011111110a0111111101111111101111111112a102110202001022222122212220221101110111110001111a11
1101111111101110111101101011111110111111011111011011010111111111011001011111011a1101110111111110111111111122b112222222222222012212221221221002011111101101111a01
0111111110110000000101101111111101111001111111111111101111011111111011011101001a1111101101111001111111111121b021110222222222212002121021102011111011110011111a11
1111110001110111011111101111111110011111110101010101111111111111111111010111111a1101111111110110111110111201a221222222222122012122012211021220111111111110101a01
111111011011111111110111111011101111110aaaaaaaaaaaaaaaaaaaaaaaaaaaaaaaaaaaaaaaaa0111111111011111101011011122b212222012122222210222022222100121101101111111111a11
111100111111111101101011111100111011101a01100110101110101001111101111111111010101011011101111101101111111122b112212222202222220222210211012121111111011111111a11
110111111111111110101011111111111010101a11111111110111111111111101111111110011101111111101111101111111111221a122220222001212220101212200210122101111111010001a11
011111010111111111111101111101011111101a01112022121220221120202121211212211111111101111101111101111111111022a101120122102102221220122220212121100011111101011a11
111111111101111111111111111111011011111a00100111022021102222221110012210221111111101101110111101111111101221a222020222111121201022002002122120111111111110111a11
111001110111100110111011111101101111111a11111211202022001020212122102012001111110111111101111111111101101221b002210212202212220000222220112111111111111111000a01
111110111111011111001111011110111111100a11111112120101121121112110120122221101101110001101110111101111101001a012000110120022202222212212100121101011111011111a00
111111111111111110111111111111111011111a10112221121022200212222112022222111111110111010110111111010111001102a111222112112120222222222222111221111111011011111a11
111101111111100111111011111111111111101a00111010021210122122011221211022021011111111111011111111111100110111a110111211011210022112121222222022011011111111011a10
111101010111111101110111110111111111011a01102110201111221121111011112212111111111101111111111111111111111101a110101111111111100111111101111111111110011111111a11
101011110001111111111000011001111111111a10111222102212222102212212111101211011111101111011111110111011011111a101111111110111110111001111111101111111111111010a11
101111111111101111111111111100101110111a10112101122111111221111111112121101111111111111111011111100110111111a110110011111111111111011111101001101110110111111a11
111110111111111110111101100111111011110a01012122211222222021100111122212221111111000111111111101111111111111a111111111111111111011110111011111011111111111111a11
111101111111011111101111101110111111111a11002111220111201012021121021012221011111011111101111101101111011111a110011001110111101111110111011111100111110101111a10
111110001111100111110111001111100111111a01102112010100010222221111120222121101111111110111111111110111111111a111011001111111111111111110011101101111111111111a11
101101111111011101010111111101110111011a01112022211110111122122122120121111001111111111111101111111111111111a110111111011111011110011110111111111011111111111a01
111111111111111111110001101011111111111a11112222121022211110112221110020021110111010100100110001111010101111a111101111011111111111011111100111101101111111010a10
011111111111010111010111111111110011111a11012101111202011221002001211212121111111111011101110011101111111011a111010111111011111111011111101101101011000111111a11
110111111101101111110110111111110111101a11110002222102110210122112112212021111100100011111001111111101110111a111111101111111110110011011111110111101100011010a11
111101111101111011111111111111111100011a10110202121221221122210221100201111111111111101111110101110111101011a100110101111111011111101111111111111111111111111a11
aaaaaaaaaaaaaaaaaaaaaaaaaaaaaaaaaaaaaaaa10111212120211122111212022002212111101111100101111111110111111111011a011111001111101111101001101011101001101011111100a01
011111111111011111111111011111011111011111101121012010222200111102020121121101111111111110110101111111110111a011111110101111111111111111011111111101011010111a01
110111111111101111111111111111111111001110112101102102211011212211121221121111111101111111001110100000111110a011100111111111110111110011111111101111111111111a11
011111110101111111111111111101011111101111111211100201211012220112102121101111111110111101111010001111111010a111100111111111111101110101111111111111111111111a11
111011111111110111111011101011111011011110012102212222122022021222222002211111111011100000110101111101110010a011110111111111110110111111011011111001111110011a10
111111111111111110111111111111111111111111112122102200221122202100222222221111111010111111011111111111111011a111111111111011011122212121112220111211220122111a11
aaaaaaaaaaaaaaaaaaaaaaaaaaaaaabaabaaabba21022112112200220121121102220211100101101011111101101111111011111111a111010111111111111101222221012121012012100221121b11
111111011111101111101001110122212121211b00122222210020201201111122001022221111111010100111011011111111111011ababaaaabaaaababaabab0012022222121111221111221122b11
111111111101110111010111110121222201021b1201202220020002021120201221112121111111111111011101111111101111110112122102122222222101a2022220222220212112120210210b11
001111001101011111110111111101222212012b1112212220012211211101212111021102111111100111111111101111101011110112120021012221211211b1221222002112212001211111022a01
011011101111111111101101101011100221002b1020222212221010111200022012120102001111110111101111111111101010111112222211221122211002b2121001222221101201220010122b10
111111010111111111111110001101211122220b0002202222201222200122212211122211111111110111111111011111111010110100122102111102112112a0101120202220222111112201210a11
101111100111110111111011111012221112221b0120222022122221202121210220122211101111111111111100110111000111001011211121212012222202a1222002112201222112202021101a01
011011111101111110110110101112122222102b1221112221211210110111111111111111010011101101100001111111111111111112110121211111221222a2122210222121101121221211212a11
111111101111101101011101101120121221022a1112222221101221221011010110111111101111101101101111100001111111101012212201122111122121b0212122202020110210222211120b11
111111111111111110111111111112202221222b2120022202211121021111011111010100111111011111100110111100010101111111211122222112021111b0221222222021012111202211201a11
111010110111111101011111001122211220211b0010121011102211101111111101111111101111101111111111001101011111111111021202102221221101b2202222221012012111002212111b10
110011101111111111101011111100222021022a2021112122120102011011111111111110111111001111100100101011110111101111221022101102021021b0221220220201201211110022101b11
101011110111101010011100101110011111122b2220111201111212001110111010111111101101111101101110111111111111101111221022212211121011b2221211222221012221111211211a11
101010111111100001111100111112201102102b2112212222222011211111011111111111101110111101011111111110111110111112212220122222110122b2212122101022120120211111122b01
111111011111110111101101001122111201222a2002221220022220111111111111111111110111110111110101100111010101101110222221221100122122b2122211210112212220211122220b11
011111101111111011011111111111210121012a1101021111112110111011011110111110011100111011111111101111111111111111121211112121211221b2222122122120120111212101021a10
111111011111110111110001101122111221212b2000021200112120121111011101110111101101011011111111111111100111111002111122111022212010b2212222222121211122202022211a11
001111111111111111111111111002221110221b0011101212221102221111011011111011111110111111111111100111111001011101111110121221111011b2200012221201121222102110112b11
011101011110111111111111111021011222020a2002202120200202120111101111110101110111101010111011011111011101111110221002100122122212b1222221210012100202222200212b11
101111111101100111101101111111011011021b2222121221121111200111110111111101111111111011111111111111101110111110201211212222012122b2001022221001210020122221211a01
101110111110110111100111011112121012021b2002100012002211111111111111111011110111111111001111101111111111011110212111101211221221b2221202021222121022211210220b10
011101111111111111111101110122102212100b2102101211121221211101101111011111111111111111111111010111111111111011012222212220222222b1020212212220212221202122002b11
001111101111111111101111101020212221121b2022122222211221201111111111011110111101101111111111101011111011111111021122220210212222b2222122212111102121012210012b11
011110111101111111111011111102201121220a1112110012101221210111001101011100111111011110110111111110110111111012111222202121011001b0222001010111220202200212222a11
100100111110011111100011111100122122222a1122221112001101220100111111011111010110101111011111111111011010110101111022111111012212b2212111221100101212022222021a11
111110101111111101111010111010121202022a1121111222111121101111111110110111101111101111011111111111111111011101122121111212211122b2122222222012220112221221112b11
111110111011001111111111111021121022202b2221201121110011211110011111111220221112122111101122021202021111110001011201101122222001b2220222012101211021011212111a01
111100111111111111111111111120111222122b2222112221200110201011111100112201122122102021201102010222021000111110121110120102112121a2012202202121221221111201111b11
111111111111111111111111111022212121211a1021011202120021200011111110112220100111012202221112011212221111111012211212201101201222b2001222222012102212122211122b01
111111101011111110000001111122102121112b1201012221122200111111101111102111112021212210011120111112021111111112212122012112002221b2200111022011111111111111111a01
111011111011111101110011111011101111111a1110010011111111111111110010112112221021112212020102211210211111111112210221222111222102a2122012211011111111111011111a11
011111111110011011111011111101111110111a1110111111111101111000011111110011112112120122222102202222221111101111111110111111111110a0100011111011111110100110110a11
101110110111001001111110111111111111111a1001111111011111111111101111111201212202122221120112201021221111111111011010111110111101a1110101111111111111111111111a11
101010111111111110111011111111111011001a1011111111111111101111111111110102111211211120220221120221111111111111111111111111001011a1111111111111101111111111111a01
101111111101010111110111111010111111111a1111010111101111101111111111100201012101202211010111222012120111111111110111100111101011a1101111111100010111011101111a11
110101010111110111011110111101111111111a1110111110110011111111111111111222100122200200212221221111221010001110100111111111011110a0101101111011111111011111111a11
111101111110111111011111110001101111011a0101101111010110110110101111010121122211102122111221021211210111111101111111111111111111a1111101110111111111111011111a11
111101101111111110110100110111101111011a1111111100111101011111111111112211020112112211121111012110101000111111110100111010101111a1111011101011111111111111111a10
101110100111110101111101101110111111111a0111111101000111111010111111012201111221111112120020222211121111110011110101111111111001a1011011101111011111111100011a11
111111111111011110001110111011111101101a1111111011111111111110111111112021121112111102201211222001101111101111011001111111011011a0111010111101101111110111111a10
111111101101101110110110110110101111110a1100011011111111111111111111100120110111102012012111210011201111111011101101111011111111a1111101111011111010111111001a10
111101111011011111011100111111111110101a1100011111111111011111111111101020112122212010111222002222111111110101111111111101011110a1111111110111110111111111101a01
111111111111110110111111111011110111011a1111111011111111011111111101011102111010212020111112020111101110100111101011011011101111a0111111001111110110111111111a11
111101111111110111111111110111111101111a0111110101111011101111111001102201110020120201222001212011200111111111111110111111110111a1111111011011100111111111111a11
111110111111101111011110111111111111010a1111111110111111011111011111110202201022102211120222220020110111100111110111101011110111a1111011111111111101011111111a11
101111111111001111111111111100101111111a1111001111110110111111110111112021122211021110222202021020211111101111011101011110111111a1111111111111110001111101111a11
111111011111110111111011101111111111101a1111111101111111111101111100012021112210022212211211222012211111111010011111001011111111a1100110100111011111110111101a11
011011111111111011111111111000100111111a1101110001111111111111111101111201221222220012121101201011200111111111111111111111101100a0111111110111100011011111111a11
111110110101110110111001111111111111011a1111111101111111111111111001100201102022011022012111122022121110101111111111111111111101a1110101000111101111011111010a11
111111110111111111110111110111010111111a0111010111111111111111111101100012212101110000212212221120221111100111010111101111111111a1111110111011111111111011101a11
111111101111101101110101101111111010110a1111110111111111110011101101011201112020121110101011101011211111111111111101111110110000a1111111110011101111111111110a11
011111101111011011110111011011111111001a1111111111011100111101111111112110212221222000101220212212011111111111011110111111111111a0111111111111111111111100011a01
111001110011110111111001100110101110100a1111111100101111111101100111111122012120212211122011002201210010010111110011111111110111a1111010111111111101111111111a10
111111000111111010111111111111111111111a1010111011111111110110111101012210011122210212121222210220220111111111110111101101111011a1101101111100011111110111011a11
011111111101111111100111010111111111011a0111010111110111111111011111111022201111210001111222220010101111101011111111010111110111a1111111111111111111011101111a11
011111111111101111010110100101011110111a1000110011001111111111111111111212021112211112202222212111211111110111111111111001110101a1111101111011111001011001110a11
111101111111101101011101011111111111111a1001111011011111011111111011011011111111101111101101111111111111111001111101111011111111a1111101111111111110001101100a11
111110110111111111110101111011111111111a0111111111011111101111111111101111100010011111111011111111111111111111010111101111111111a1111101111011110101101111101a11
110011111111111111011111111110011101111a1111111111110101110011110111111111111110111001111111101111111111111010111111101011011111a1011011111011111111111010110a11
110111211120212122202101101012212111111a1111111111011111111110110011011111111110001101101111111111111010111111111101111001111111a1111011111111110111111001111a11
110111101112202200222112222212011211010a1110111111000011110110011111110101111011011111111111111111110101010001111001111111111111a1111110110111111011111010111a11
111101011022100122200001021200212011110a1111001111111110100111111111011011111111011101110011111111111011110111111111111111011111a1010111111111111110111101111a11
111111010201211200212021212122101212001a0111111110101110101111111110010101010011111011111111111111111111111000110101011111101111a1111111111111111111110101111a11
111111121211021201221211121212122011110a1110101101111111111111101101101111111110110101101100111111101110111110111111110001111111a1101111110101111001011101110a11
111111101121221110220122222222222212111a1111000001111001101111110111101111011101010111111111111110110110111111111111111100110011a1111011011110010111110101010a11
010111001111120112110101221010201220111a1111111101100110111111111111111111110101101110011110101111110011111101111101001111001111a1011101110111101110101101111a10
111101222120211102120210000222101122111a1111011111001111111111111111111001111111111101111101101111111100111111111111111111100101a0101111111101111111101110110a10
111011021222021221000100221210212112011a0111111111111111111111111111011111110010111011111100101110111111111110111111111111111111a0111001011101110111001111101a11
011100220101211012012212121121202121101a0111111011111111100101111110111101111101110011111111111111111100111011111111111111101010a1111111011111111111111111111a11
001111112210011221122222222112211020111a1100111111100011111110111111111111110011100111000100101111110111101111111110101111111011a1111110011011110111111110111a11
111110112102100001201200012011022212111a1111111111011111111101111111111001111111010111111110111110011101111111111101011010111100a1111110001011111101101011111a10
111111201011012012222111122101211122111a1101101111101111101111111001111111111111111111011111111101110001110111111111111111111101a1100111110101111000100111111a11
110011212202121221012121211111212222111a1011111101010110111101011111111111111011111100011011100011111110010111111010111011011111a1110101111111111111111100111a11
111111021111211221112111220222022212111a1100000111111011110111010101001111010101011101111110011101111011011111110111111111111011a1000101101110101111101111101a11
001111012211121201120112220121201211101a0111111111011111111111100010111100101110110101111111110111111110111111001111101101111111a1111111110111001110111111111a11
001011110121122220011202201120122221111a0111111111111011111111101111111111100111111110111111110111111110101111111111110111010111a1111111011110011001110110111a10
110111211000021222212111222212022000100a1011110011111111011100111111111111001101011111111111101111111101111111110110001111111111a1110110011111111111110111111a11
111111021221100022022212102122122022111a1111101111011101010111111110111111011101101111111110100111110111111101111111111011111111a1111111111111111111111111011a11
101011212210022121200211022022212201111a1101110110111111100111111111111011101111011111111111111111110011100011111110111011101111a1111101011111110101111110111a11
011111122112110022212122122221212102101a1011110111111111010010101111100010101110111101111111111011111111110011111110101011111111a1111100111111101111111110110a11
010111111222212002121222102020102212111a0111011111111111110110111010011011111011111011101111111110101011111000101111011111111111a1111011111001111011110111011a11
111100202211122100121212221212111022111a1011101111111110111010110101011110110111111111111011110011101111101111100111110111011101a111011101110011110111110111aa11
