(118,137)
(0,0)
(80,58)
(27,53)
(69,51)
(91,134)
(84,48)
(99,80)
(8,127)
(20,131)
11110011111110111110001100111101101100111111111011011010001aa111011010011111011111011100111101110111011000111001122111200220021112210212100212111111111111111111
11011101111111100111111011111111111111111101001100111110110aa101111011101101101101111111111010110111111001111111211121210212021222221211110210111111111110110111
11111000011111111111111011111101011001111111111101110111111aa011111100111111101011111111111110110111011001110111122121201202122122112111110100110111111111101110
11111111111111000011110111111111011011111110111111111111111aa111111111111111011101111111111101111011010111111111001212211212010112020221110021111111011111101001
10001011111111110111101110010011101111110111001101111111101aa111111101101111111001011111111110011101101101011111112222221102112021122012110212110111110100111110
11110111111011001011111110110111111111011111011111101101111aa101111111011111111111111110100110110110111111101011120022220022210222112121220222100001111111101111
11111111111111101111111111101111111110111011011111111111110aa111011111111111111101111111101111111011111100111111112021221222000002221202202221211211111111111111
11111011011111111111111101111011011111111001110111101111111aa111101110111111011011111111100011101101110110111111222110122122222221012221101122221210111011011100
11101111111111111111111011111111111101111111111110011101011aa111111101111111111110111101111111101011111010110110221112221021022122201102012221212211111101011110
01111111101111110111111111111110011111111111111101111101110aa101100111111010100111111101101111110001101010111110222002020122222122222202222022121201111110001010
10110110111101100101111111100111001011111001111111110111111aa111011101001011111011101100110111111011111111111111220220210202010222122201212112122101101110110111
10011111111100111111111101111011111011111111011101111111011aa111110111100110101001111001011111111111111101111111200111221121212222012222220212100011110101101111
11011001111111101111111111111111111111100112122110221121122aa112011201111011111111110111111111111111111111110110212202222222021222022222222021221111001111110101
11111011110011111111011111101111111111211012022011210021112bb221222211010101111111101110110001111111111111111111001122221102221210112210222201220111110111011001
11111011111111111111111111111110111100102101121102101101111ba221111111110101111111101011101111111011111100101111112112220202201221222212012002021010111001111001
11110111111011111111111101110111111111000201202102211111022aa112012011111011111111111111010111111101111111110011120121022122221020222211212222011211111110111111
10101111111111101111111111111110111111121212012100122012220aa111012211111111111101110011111111110111111111011111222222212202112112022101222122220101110111111011
01111111100111011111001101011111111111101120221210210212201ab212121011101111011101111110011111111111111110111111222122222202122022221122011212121111111101111101
11111111011111111111111111111000001111021202112121222120021aa021222200111011001111111011110111111111111111111110201112202222222222012222122120212011011111111101
11100010111101111111111111111111011111121212101112102111222ba210221101011111110111101001111111111111111111101110222221110222222110201020220122202110111111111111
11111110110111111111111111011011101101222212211112221212112ba102222010110101111100010001111111111011101111111111201000110222101021201020220221102211111001010111
11011111110011110111101111110111111001211101121222112211212aa011102101110111110100110111111111111111111011111110222212122120112210002221222120112111111111101111
00000110111001111101111111110111111111010012102012110111101bb210020111111101111111111111111111101111110010111111202122222110211222022221210202212010111111101111
01011101111001110011111011111111011011202202210000100222021ab212212111011111111011111110110111111110110110111111111122001001210222021122212222220101111111100101
10101111111111101010111110101111011111100212122202010112102ab111221111111111111011101101111111111101111111111111000112202220222201121121221102012110111110111111
11011110011111100111111110111011111111001221122202211011120ab220120111111011111101110111001111101111001011110111111111022201210122022121020022000210111101111111
11111101111111111101010110111111111100201012222011022201112bb212211211111111101110111111111111011101011001110111111112202211121022211111222102210011010011010011
11110111111010111111111110111111111001112221122212221112101ab202202211111111101101111111001100111111111110111111111121210221112112122121112202110101111111011011
01001011111111111111111111011111110111122201212110120222021ab111202011111111111111111110110111011111111000111011110120211221122120202201111111000211110111011111
11101101110111101111111111101111111100220101112211121220112bb220012101110111110011110111111111111110111111111111010022220211122211221210101222002211011110111111
11000101011111111000001111110111111111212022201122011212121aa211221111111111001111111111100110101111101111111111111100212102220212222112211100110111001111110011
11110111111101100111111111101111100111100011222212211112221ba010210111111111111110101110111101111110110111111111111112121202011211112111200021121011111110101111
11111010101110101111111111111111101111110001220200121212202aa221102110101011101111111111101110111110001111111111111121211220022121201201200212222011111101011111
01110111111111111000000111111101111111011100121012200212101aa122111111111111111111111111111011110110111101111111111102201221221002212011111011012200111111111111
11111111111100111111100011111111101111211110220222122101211aa200212001101111110111011110011111111111011100111111111011122221111222102102101121101101101111001010
01101011101101011111111101111111111111211221221210212221221bb222010111111011111011101111101011111101111111101111011111111011111111010011110110111111111111110111
11111101001111011111011011111111001101021002210210122002101ba220210011001110011111110101100101110111111111111111111111101001101111111111011011110111111111111111
11111101111011110111111111111111111111221110200201011112221ab122210011111101111110011111011111111011111110011011111111011111100111100111111010101111111101011111
11111111111111101011111011010111001111101112222120222111201bb212110211111110101101111111101111000111100001111101111110110101001111111110011111111111111101011111
10101101111111111010111101011100011111121121212221212110210bbabbbabbaaaaaaaaaaaaaaaaaaaaaaaaaaaaaaaaaaaaaaaaaaaaaaaaaaaaa111111000110110111111011101110010110101
11111111111110111111101111111111111111122220212112210210011a020221121011111011101011111111011110111111110111111100111100a101011111111101101111110111000011110001
11111010101011111111011101110010111110212111221222012212222b212201021111101110011111101111111000100111111011111110101111a011111111001111101011111010111111101111
11100011011110011101111111111111111111111101111111011110111a111100110111111101111111010111011111111110111101111101011111a111011111101111110111111111111011111111
11101011111111011111111100101111101111101111111011111111111a001111110110111111110111111101110101011111011111100011111101a111111111110111111111110101011111111011
11011111111111111111111111111001111111101011110110111011001a011111111111001111111111111111110111110111111111110111111111a110110111101111110101111111101111001110
aaaaaaaaaaaaaaaaaaaaaaaaaaaaaaaaaaaaaaaaaaaaaaaaaaaaaaaaaaaa011111111011011111101111111111001101101111111111011111111011a111111111111111111111010100111111111110
111011110111011111111001111111111111111101000111111110011110110111111101111110101111110110110111111111111110111111111111a111110111100111111111111111111100111111
101110111011110111111111110111111111111111111101111111001111111011101111101111001110111111101011110111110111111111011111a110111011111110111111110110011111111111
111111111111111111110111101110111110101111111111110111111111111111111111101111111110111001100101111011111101011111111111a101111111111110111010111110101111111110
111111111111111011111110011110101111111101101011111111100010111111100111111110111101110110001111111111111000111111101111a011110101111101111111010111111111111101
111111110110101001011110111111111111111111111111111111010111111011011111111011011011101110111110110111111101011111111110a011010111111111111111111111111011111100
111111111111101111111111101111111011110111111111110111111011001111111111111011111111010101110011101111111110101011111111a111111110111111100111101111100000111111
111100111101110101110111101111110111011011011111111001111100011111111111110010110111111111110111100100110111110111110111a011111111111111111111000110011111101111
110110111011111101111111101011111111111111111101011111111111011111111111101011111111101111011011111011111101011111111110a100011110101111011111101111110010111111
100111111010111111100111111011000110120211211222220221222112022020010101011011111111110111111101111111111011111111111111a111111101111111011010110111110011011100
111001110111111011111111111111111111212221021122112111101121012202111010011111111111111111110111011111110111111111110111a110111111011111101011110111011101110001
111111111111111011111111011101110111122220211211010222210211101221111111111111011111111111101111111110110010111011110111a111111111111111000111101110011111111111
111111101111101101101111111111101101020122121120111101122102222102111111111111101011111100111011110110011111111110111111a111101111101011110011111101111101101111
111010111111111011100110111111111011102221212121012221100100012210111101110001111111111110111110111111100111101111111010a111110011011111011111101111111101111110
11110111111111101111aaaaaaaaaaaaaaaabababbbbbababababaababbbbbabaaaaaaaaaaaaaaaaaaaaaaaaaaaaaaaaaaaaaaaaaaaaaaaaaaaaaaaaa011101111001110111111010011111110110111
11111100101101111101a1111111001111111110211222122221010102221202221111111010111101001101111001010111110111111101011101011111011111110111110001111111110110111111
11101011011111110101a1111101011111112102202211111112122211221122111111111111101111111011110011101111111111111111001111111111110011111011111111011101111111011111
10011111101111111100a1111111111111112102112111221122111220222011101111111110111110111111011111101011110111110111111001111101111111111101110111101110111111111111
11111101101101110111a1111111101111111210111112220202200112001112221111111011111111110110111110111100111111011101001101011110011010110110111111111101111110111001
11011110111110011100a0111111111011101201121200222120021112121012101110101101100111110111101001111101111111111010101111011111101111110011110100111111111111111110
11110111111101110011a1011111111110110112211022202110210212212202201022112011111111111111011011111110110110111110111111111100101111100111111111111110011011110011
01111111010110111111a1111101111111101120101101202212122111221222201201102110111111111101111011111011110111110111111100111111110111100101100111010111111110101111
11111101100110111111a1111110111110112121210120202120222222222002201011112111111111011100111001011110000111111111111111011011011101111101111110010111011111111111
11111110101110011011a1111111111101112212012202212202202120022210212221221011011111111111011111111111110111111111111110110111111111011001001011101111111111101111
11110110110110110111a1111111101112120222101222202122222222022020022111110110111101111111101101100001110111101111100111111101100110100001110011101100110111111111
01111111011101111111a1111011111111121210100102122222222002222221112212222001111111111111111011101110011111111111001101111111011111111111111011101111111111111010
10101111111111111111a1111111111110122020022222220112122022222222220102112111011111110111111011101110111111011001111101101100111110000110111110111111100111111000
11111111011110011110a1111011011112122222122222200222212201222220022212122011101010011111101111011010101111111110111110111111111111011111111101111011011111101111
01011101011111111111a1111011111111202221222222222222202222221201111212011010111111111111111101001101111111111111111101111111011111111110111110111011111111111011
10011001111111111111a0011111111111002222220201222022201202202222201220121011111111111111101111111111110110111111111011111001010110110111111111101101111101111111
11110111111101111111a1010011010111000102220202222222222122222202220201010111111111111011111111111111011111111101100011011111101111111101110011110111111011000011
10110011111110101010a1111111111011021011babbbabbbbbbbbbbbbbabbbbbbabaaabbaaaaaaaaaaaaaaaaaaaaaaaaaaaaaaaaaaaaaaaaaaaaaabbbaabbbabababbbabbabaabbbbaaaaaaaaaaaaaa
10101011011111111111a1110010011101112022b21022222220220222002200202211020101111111110110111101111111111001011111110000012112121121222022021122122020111111111110
11111010110111001111a1110110111102122222a22102222222120222222221212022020111110100111111111001111111001111111111111011022221212222101010212211101011211011110101
10111111111110011101a0111011111110222002b20212222222202220220210122210112011111111101001101101111111110111111111111111021111222112221112020102202110211100111111
11101111011011111011a1111111101112112201a021222212222002222022220020aaabbaaaaaaaaaaaaaaaaaaaaaaaaaaaaaaaaaaaaaaaaaaaaaabbbaaaaaaaaaaabaabaabbbaababab11110011011
11111111101111111101a1111111111111110211b002222020222021222220000111b1222111000101011100111011111101110011101111111111112122222211220001222211120221a00011110111
11111011111110111111a0111111111112202222b222202222222022212121222212b0001111111011110110111101111111111011101111011101021020212021111012220221022111a10111111111
11111100011010111010a0100010011111221222a022221020022222120222022002b1120111111101111111111101111101010010111111101111111021221111121020112222102222b10111011111
01010111111111101111a1111111011112222122a122222202102202021220011222a0210212101222112102120122111110111111111111001111121211211211211111122101221101b10110111111
10111101011111101101a1111111101112222121a222221212122220201200221020b0211112121101012212221212110111101010110111110110102111220222111222122111112021a11101110111
11111111110101010111a1011111111110110022b211022222112222202220022020b0102202001221020111212001211011110011010111111111101211011210111121222111212202b11111001101
11111101111111110111a1111111011102121022b202120212220100000112020012b2212111202110022112002111010111111111011111001110122211221222010001102022211200a11001110111
01110111111111110111a1111111111010111120a212122212222221220222021201b0222122111122102222212210011111101111101110110110112211112110001112200001122122b11111111001
11110111011101111000a1011111110112222102a212122222220202222121111201b0221211112120211211021221011111111111101110011111101010022221112212111112121222a11111101111
11101111111111111101a1111111111111112200a222221122200222222222212022b1120220111012212101111212011001111101110011111111102100000220012011001210200220b10111101111
11111011101111111110a1101111110101021221a221102122222222212222222020b0002111221202211122222111111011011111011111111101112121212012110202011002111212a11111110101
11110111111011101011a1101111111110121022b221022112201210221220201220b2012120221122211122022112211110111110111011111011121212102211221100122022112211b10101110011
11111111001111001111a1111111011012022212b222020121202202222210220212b2222121222020211120122112210101111111111100111110101110212212222121111101211021a10111011011
11111100011111111010a0111111101110022122a102012122022211220002112222b0221120220120212121111210110111111110011111101111112121211102222221112012120211a11001111101
10111111111111111111a1111100111112022020b122202220212121212111111021a1112100101022120202122102111110111110011101111011121211122100101221120211122111b11111111010
11111101111101110111a0110111111110200121a220212011210221110110200220b2021221112102111101222221211001111110101111011111012112122122121111020211212212a01111111111
11111111110110111111a0111111101100112102b211001212222111112022111221b2121221012122021011102122000111111111101111111100122122001210212222202102121202a10111101111
11111111101111111111a1110111110112212212b011022112202010011122011122a2210211201121012221212211011111111011101111011111121221222110222002211122012120b11111111000
aaaaaaaaaaaaaaaaaaaaa0011111001111111111a110111111111111100111001010a0010111021222111211101111111011111111111111111110012121111112212022120212201221b01110101111
1111111111101110101110101001011111110110a011101111111001110110101211aaababbaaabbabaabaaab12222211010111001111111111111121022112112102201221002220212b11001111111
1011001111111111111101010110101111111111a11101111111111111101111102120211212111121122022b01001101111111111111101100111112212020122101112121112220120b11110011011
1010011111110111111001111011101111111101a10011111111110111111011122222221000010111120221b11022210100011100101111111111101221221212120220020210112212b10110110001
0111111101110101111111111011010111011101a11011111111111111111011112210021110211002121212a22122111101111001111011101111102122111121110200121112012101a01011111111
1111111101101111101111110111111111111011a11111111111111111111101121221000112210221211102b11221111111000111011000101111012212101121100212022211222122a11000101111
1101101111101111100111111111010101101111a11100011101111111111011010012122221021122111121b02011011111111111111111111011111012121212221221110220010212a10101101111
1111111111011111111111111101111111111111a11111110010111111111111020121021221002221211221a00210011101111111100111111110001111111010110111100111111111a11111110011
1111011001111111101111111011110011111111a10111111111111111100011120111012101201212202001a12012101111111011111001100011111111111111011011111110011101a10111010110
0110011111011111010111111111111011111111a11101111111001111111110112002222111211210100021b12002111101111111111011011111111011010110111111111111111111a00110111011
0111111110001111111111110011111110111110a11011111101111111111101022221111202122121012121b12201211101111111111111111110111111011111111111110110110011a01111111111
1111110111111111111011111111111111110101a01111101101001011111011111000111102022211121021a00212101100110111101111111111111111111111101111111110111111a11111111111
1011111101111110111101111111111011110111a11011111110111001101110010111211212220211021111b22211001001111101111111110101111100110110100111110111100101a01010111111
0111011111101110111111011111101110111111a11111111111111111101101112101121211022022121222b22100110111100111111111111011100110011111111010010111111101a11011110111
1111110101101111111101111001110101111011a11111110110011011011011121200121212111002120120b11000111011010111111111111111111111011011100111111101111110a11011111101
0111101111110111100111111110110111110011a01101011011111111111110111101101100111110110011a11110111111111011011111111110110111111101111111111111111111a11001111111
1101101000110111111111101111110100111111a01011111111110101011011010111001011010011111110a10111111111110011111100111111111011111011100111011111000111a11111110100
1110111111111110011111000111010111110110aaaaaaaaaaaaaaaaaaaaa011101111111110100101111111a00001110111110111111111111111111110110111111111111011111011a11011011111
111010111111011111101101110111101011010111011111011111111000a111011100011111001111111101a11111111011011110011011111101101111111001111111110011111111a10111111101
100111111101101011111111001100111101011111111111100101011111a111011011111110111111101111a01111111011111101110111111110111011111111111111011111111111a10111101101
111111111111111110111011111111111111111100100111111111011011a101011011111010111111111101a11111111111011101111111111111011111100101101111101101110101a10110111101
