(33,13)
(108,155)
(4,154)
(106,149)
(110,132)
(21,83)
(2,45)
(101,139)
(52,136)
(92,120)
11111111111111011101101110110121222121112111122012212121210b1111101111a101101111110111a1001110111011011001011111011111111111111101111111100110022111102202021121
11111111111111111111111111011102012222212221120012202120220a1111010111a111011101111111a1011111110011111101111111101111101111111101111111111210222222121111111211
01111111111110111101111110111021122110022222021012212200210a1011111011a111101111111111a0111111111111111110111111110111111111111111001111111221222222012121011121
10111001010101101101111110111111001101221220211010210210121a1111110110a011111101100101a1111111100111111111011111111111110111111111101011111110112212111111212222
11111111110101111111111101111012111201201012112202211222122a0110111011a111101111001111a0111011111111100110111111111111111111111111111110111002111221202201122121
11011110101101011100011101111010112000122201200212101122102b1110011111a011100100011111a1100101111111111100111111111111101110111111111111011002101221211111012211
11111110111101110101111111111111112002212111210122212121221b1111110112b100221121222212b2020121112201111100111111101111111111100110101111011210121111211111112121
11111111011111111011111111111122102010221212211120122101011a1110111101b122111002202112b1121210111111111111011111111110110010111111111111111222112221011201101110
11101111110111101010011111111111111102222121221220120212112a1111101122b222222222122120a2101212112210111110011101111011101111011111100101011222202111012011021202
11111110110111101111111101111122112212011012222120121221202a1111111012a122101212022211b1210122122211001101110111111111001110111111111111101111222101021220011110
11111111111111111101111111101012220211120002112221121220211b1111110121a211021201102022a2122122121111111111110111110001011111110111111110111121221121220211121212
11111111101011101111111111101112021222102211220112221122001b1011110101b222122020112122b2021111022000110111111111011100111011101111111111111222221021200011020222
11101111110011101010111011011111011012110222001122212122122a1111111121b012221121222000a1010212212111111111111111111101111101111000111111011122022112211002121201
01111111110101111111111101111120211011222111212001111022002a1110111122b010122022212210a0212122001001111111110111110110110111010111011011111121002021200121120012
11111111111111011111100001111111110111101222221022112112011a1011011102a220220022211020a1012112120110101111111111111010100111011110111111111222102110211110112111
11011100111101111111101111110101110112021222012110121212212a1001111101b211200222211121a1210111201101111101111111110011101111111010100111111222022101201110120120
11111111111111111110111110000111222122111012021210211121221a1011111101a121220102210222b1222102111111111110110111101101110110111011110111001202112021021110012221
11000011111111111111001110111110111110111111101111111111000a1111111112b022200211121110b2112102102001001111111111110101011100111111111111101111221211222210222222
11111111111011011111011011110111111110101101110111111111111a1111100012b021122220221022a2220222011011100111110110001101111101110101111111010002001102222220112212
10110111001111111011111111111001001100101101111011011111111a1111111111a222222212010220a2100122222011111111100111111111111111001111111111010110111111011111111111
11100111111111111110101111010110111011011110111101010101111a1011011012a100101112221221a1021102010101111111111110111011110011110111111110111111111111100101011101
11100001011111101111011111111100111101010101110111011110011a1111111021a222212221100100a2102221111001111111011101101111111011111111101111110111101011111111011001
01011011110111111111111111111011111111101111111101111111111a1011111012b212222122211220a2120211001211111101101011111111010100111100111111111101110011101111111111
01101101111011111111111111111111101111010111011111010111101a1111110121a022122212112120b1221001111211110011101111111111111101011000111111110111111111010111100111
01100000011110101111111111100100011110111011111101111010011a1111111111a120111222110220a1010022101101101111111111111111011111111111011100111001001111101111111011
00100011101111111111111010001111011111010111011101111111111a0111111122a012211202221201a1212222222211111110111111111111101111011101110111010110101011001111111111
11111111011111111110111111111111011111110101011111111101111a1110111111a111211220121112b1212121020201111110110110101111101111110111101111100110001011111111111111
10111111111011101110101111110010110110111111110111011011011a1111101112b121121211211202b0121221222211001111111011111111110010011110011110101111111111111111001101
11010111110110111111100110001111111001011111111111111001111a1111111121a101212212222010a1220022120201111101101010001011111111011111110111011111111111111111111100
11010111011101011110111111111110010111011100110111110110111a1111110110b211112212022122a0221212112011011011010111111011101100111110111101111101111111111111111111
11111011101111111111110111011110011111111111111111111111110a1110010112a011202101101001a2000111212111111011100111110101011111101111101110111011111111100111101001
01111110110111111011110110101101110011111111011101111111100a1111001121b012012212202221b1101201112211011011111011101111011111111010111111111111101101100111011110
10011101111111111101011111011111111110110011111101101111111a1111111110b122210121211201b0210022112200111111110111111111111011111110100111111101111111111011000111
11011111111111011111101111110110111110111111010111011110111a0111100022a222122211210100a2102101202101011111111111111111111111101111101100110011111110111011011111
11111111011011010111011001111111011111111101011111011111111a1111111121a112012122101011b2112022001101111111101101110001001011111111100111111111111111111101111111
11111011111110110111011100010100111101111011111110110111111a1100011002a222021020120120b2210201210211111111101111101001111011111111111111011010110111011110111101
10110111111111101011111111111111111011111111111111111011111a1111101111a111111101110010a0110011011011101101111111111110111111111111100111001011100111001111110111
11101111011011101111111001101011110111101011111111110101011a1111111111a111111111111001a1111110111111101111101111111110111202011110111221111121201220121010111111
10111110111111101111111111111000111101110101111111011011110a1101101110a101111010111001a1111111001111011111111111111101111121220012200011102121112102020111111111
11001101110010111111111011111111010111111110111011111111101a1111101111a111111101111111a1111111011111110111111111111110111101111222122100220212101122121111111011
11101110110111110011101111011111011111111001111001110011111a1111111111a100101111110101a1111111111111111011111111111110111212020111222220122122002112100111110111
01101111110111110011101110110101011110110111111111000111111a0110110101a010101101111110a1111011111110101111111111110111111222211222222102111221012122202111111111
11111111111011010111111111111111111101101111111111011001111a1111111111a110111011111111a1111111111111110110101101111111111221210010211000212222222120020111111110
11011101111111111111111111111111010110010110011111111111111a1111111100a100110111111111a1111111111110111111111111011011010222002121111010221212221221211111111111
11111111101101111110110111101111111101111111011101111011111a0111111111a011111110111111a0111110111111111110111101101101011221111121212010222121112002221111011111
11111010111111010111111111101110010110100111011111010111111a1111011011a110111111110111a1110111110111101010111111111111011220222021221111122112221012100110111110
00011111111011011111111011111111110111011110011101111111110a1111111011a111011101011011a0111101111101111111111001111110101122222121002220112122210221022011101011
10011111111111111110100111111101111110111111111111100101111a1111101101a111110011110011a1111111001111111111011111111111101202112212121200222212102101012111110111
10011111110111111110001111111011110111111011111111111111011a1011111111a011111110110011a1011011111100111111111101101111001102221211111111101211010122222111001111
11001011111101110111100101111110111111110111101011100111100a1111101111a011111001111011a1111110101110111111111011111111111122020122121221212020112121011111100011
11111111111111111100111111111110101111111111111111110011111a1010111101a110010101001110a1101111110111111111101110110111110211011202202021221111102101120011110111
11111110110110110101101111110111111111111111111111111101111a0011111111a111110101100111a1101111111100111111111110111111011011111102222000220210220122222011011111
10111011011110111011101111111111011101111111111011111111101a1111110111a111111101111111a0110111111011011111011111111111111111221212012111112121112212111111111111
01101011111111111111111111111111111101111111111111111111001a1110001111a111001100111000a1101110101100110111110111110111111020212212012122112121021222102101111101
11011011101111111111110110101011010111111111111101111011111a1111111111a111111111111011a1011101111111111111111011011011011212101121201111212012200121111010111011
11111110110111001111111011111011101000110111111011111111110a0111111111a111011011111111a0010111111111110011111101111101111122112211220002202222201201111111101110
aaaaaaaaaaaaaaaaaaaaaaaaaaaaaaaaaaaaaaaaaaaaaaaaaaaaaaaaaaaa1111011111a111101001011111a1011110111011111111011110111111111022010012220100022211222102122111111100
1101011101111001001011110111111111111011110111111010111111101110111111a101011111111011a1011111110011011110101000111111111221211011120122102212212222110010011110
1110111100111011111111111111111111111110010111111011111111111111111101a111101110111111a1111110001111110101011111101011111211122121212212212212001210110110111011
aaaaaaaaaaaaaaaaaaaaaaaaaaaaaaaaaaaaaaaa111111111110111100101111011101a110110101101111a1111111111111111111111110110011101221121111202102200221112110221111100110
101111111001111111110001110101110110111a101110111111111110111011011111a111111111111111a1111111110111101111111111111111111211221212001222020221102211021111011111
111111011111111111111111111101111111010a111110011111110111111111111101a011110001111011a1111110111101111111101111111111101012212120211112121202212010111001000110
111101111111110111111111111011111010110a011101101101111110111010011111a011011011100111a1100111111111101111111101111111111221122000220122011002122111020010101111
111011010101100111101101111111111111101a111111101111101111111011111011a011010111111101a1100111111111111110111111110111111222111212112121210102021111211111110111
101011111010010101111110111110111111111a101111111101111111111111101111a111111011111111a1111111111111110110101111111110111022110122222200120210021221220111111110
011010111111110111001010111111011011011a111111100111010101001111111111a101110111011111a1110110011111111110111100111110011222022111021212121101210112222011111011
111111110111111111101111011110111111111a111111001111111111101111000110a101111111111110a1011101111010111111111111101001111111020100211210201111221121211111111111
101111111111101111111111111110101111111a101111101111110110111110111111a110101111011111a1111111111111001111101111111111111111111111111111111100111111111101111111
100011111111101111011110110111011110011a111111110001010111111010011111a101011101111111a1111111101110111111001110111111000111111011111111110111110111111111111011
111111111111101111111111111101111011101a110111111101111111101101111111a111101111111111a1111111111111111011111111011111111110011111111111111111111101110111111111
111111101100101101111110110111111101011a110111110011011111111111100111a011111111110110a1010111111111001011111111110011110111111111111111110101011111111010111100
101111111010101101111111111011101010111a111110111001010000111011111111a111110111111110a0111011110111011101111111111011101000111001111111111101011111010100101111
011111011111111101111011111111101111101a101111111011101100111111011111a101011111110111a1101111111110110111111101001111111001111111110111001101111011110111111111
101111110111111111111110110111101111111a101111111101111110010111111011a101101111100101a1111011011111101110111001111111101111111111011111111010110111101111111010
101011011111011111101011111101111111101a101111110111101111100100111101a111110110111111a1010100111111100011111111111111111110101111111110110110111111001111111111
101111111111111111111111111011111101111a111110111101110011001001101111a110111111011111a0111000111111110011111011011111111111110111111011110111111011111111101111
111111111111111010111111011110111111110a011110111111111110111101111011a110111111001111a1111111111111100100110111110111111111111111101111111101110101111010110111
111111111111111111011111110111010111011a111101111111011111110110111111a111111111111101a1001101111100111111010222202112211112222210222221111111111111111111100111
111000111110111111111111101110001110111a110110111111111101101110101101a111010110101011a0010111110011111012022122201111221111122112102021111111111111111110111111
101011110010110110110110111110100111101a111011111111110110111011111111a101101111111111a0111111110110101110221101110002022011211121202220111111101101110001100111
100111110111111111001101110111110111111a111111101111110110111101111111a111111111111111a1111101111111111112202012102112101110121122221211111111111111111111101111
111100111001110111111111111111011110011a110111110110111010011001110111a101011011111111a1110101111010111112212211211212121112201221212111111110110110111111111010
010110111101000111111110111111111011111a101110111111001001111011111111a111110111111010a0111111111111111111011211122212012110202212122200011101110111111111101101
010100101111101111011111111111111100010a111011111111101111111111111111a011111111110111a1111101111111111112121220012112211222210212221111111011011111111111010100
101111111110101111110111101111111111111a101111001111110101111111101110a111101111111111a1011111001111111111212222022220212010222221101111111111111110111110110101
111011001111110111111111101110101111111a111011111111101111101101110101a111110011111011a0110111011010110111110121101012201112211122211121000111111101111111111111
111111111111111111010111011111111011110a111110100111111011111101111111a011111111011100a1111101111110111110001211112212212212222202212212102212121010122211111111
010001001111101111111111001111101110111a111111001111101011111001100111a111011111101111a1110111111011111012101222110001111121222202222220212111212210210121111111
111111110111110111111101111010011101110a111101101101101111110010101110a010111001110001a1111111011111110112222111201121111012102020122222000010221220111222111011
111100111011111111111111111111011111101a011101101101111101111001111111a111011101111111a1111011011110111112211122222012022120121012222220102011211121101200111111
111101011101111001111111101110111101110a111111001111110001111101110110a111101111110001a1001111111111101011112220212022101211201222212221212222121121211011111111
110111111111101011101111111101110111001a010111100111111111111111111111a111011111111111a1011011111011111112101202211211122102101120220120020102222111201222201121
111111011000111111111111111011101111111a111110111111111011111111101111a111111110011111a0111110111101011111122110012121202211212122222220220212122222201221122102
110101111100001111100011111010011111111a111011111011101011001011101111a100111101111101a1101111101011111112100211211122101120222221212200222211120021221221221222
111111011110101011101111111011111111101a101001111110111110111010110100a111101111111111a1011111101110111112211112120222111212011222222222210012202012220211221212
110011100110111110111111111111111111111a110111111001001111011011001111a111111111010001a1101111101111100101111111122002112222212222220122220222202222122220112220
110111101111011111101011111101111111100a111110111101111101111011000111a111111011111101a0101111101001111111011110020112022022022022222002122202222222222202201222
111111011111101111111111100110110110111a110101111111111111111111111111a111110111101101a1011111011111111112120100102112222200202221022212112222222221022212202112
111101011110111111110011111100111011111a111111111101111111111101111101a011111011111110a1011111011101111112110122201212022212000220222101022022202122201212111222
aaaaaaaaaaaaaaaaaaaaaaaaaaaaaaaaaaaaaaaa110010110101011111111111111111a111111111111101a1111111110111110110221121110122222120221222222222221202122022122002220110
1111111011101101111010100110111111011111111111111111111111111010111100a110111011111111a1111011110111011112110100220121212110222222221002200022220211021210011121
1110111101101111101110110011101111111111111111110111101111110101111111a111111111111111a1111111111111010111012122221122122012221201222222222202222222020202201222
1110111110011010101101111111101100111111110111111111011101111011101011a110101111111011a1111111101111111111112112201120222021220222201221111220022222020221102100
1111111111000010111111101111101111110011110111111111111101011011110011a111101111111111a0111101110111111101111221110122022202022202220220220222222210201202201221
1011111110011110111111111111111100111111110110011111011111111111101111a111100101111100a1111111011111110110221102000010221002222202220222102102212202202222112211
1111111111111101101011111111111111010111101111111111111111101110111111a111111101101111a1111011110111101110001121200210202201221222122222000222201202121222211102
1101110101111111001011011110111101111100010111111111101011111010111111a111111011011110a1111101111011110001111222112110222212220221222222222200222222022021121210
1111011100111110111011111001101111110111111111111111010011111111111111a110111101111111a1111111001111111111000111111112211110022202221222222020222222222211111121
1111111111001111111110011111110100011111011111111111011111111100101011a111110011010111a1111111111111000111101111111110121111221020212122012222022002102202222022
0111111101111011111110111111111111010111011111111101110111111101111110a111111101111111a1111110111111111101011000111112112122220222212220222202222222221222022202
1110111110111110111111111011111010111010111110101110111111001001111111a111110001111001a1111111111011111011111011101112002101212202222222222220222212021222221122
0111111111111110011110111010111101111101011010011011101111101110111011a111000110100011a1101110011111011111011111101112001201202221022122222222212220012222200122
0111101001101101111111011101110111001001111100101001111111111111101011a101111011100011a1111111111111111111101011011011212111021021202222022222201222200222102220
1101111111010111110101101111011011111001111101111110011110010111011110a110001101101111a1111111011111111111110101011112121010222222202122222020221222220012020121
1011110110111101110111111010101110111111111111101111011111101111111111a101011111111101a1111111111010001111101111100012010202222102202202222000222202100222021211
1110101111101110111101111111110011110111111101111110111011000111111001a101111011011110a0110001111111111111111101111112022212202222021011202200202222122222212112
1110111111110111101111111111111111101111111111011101111111101111111110a111111111101110a0101110100111011111011111100111222102100112222221122122121211021122111121
1111101111111111010111111110101111111101111111111111011111111111101111a011111111111111a1011111111111110111001111101011121011210222220212012021102222020220221120
1111110110111101110011111101011111101110011111111110111001110111111111a111101111111011a1100111111111111111111010011110221112212200021222012122012020112001201220
1111110101110101101101111111110111111111111011110110111011111101011101a111110111111101a1110100111111111111111110010112111111201211112122112220120222201011211212
