(16,147)
(42,1)
(68,60)
(114,110)
(49,9)
(63,70)
(77,41)
(0,128)
(85,65)
(18,19)
111110111011111111111111011111111a11111111111001a1010111110110010011111111110101111110011110001111011111001110111002011221121112a0121221200122111111110111111111
111111011010011111111111011010111a11111101111111a0110100111110111011101011110011110111110100111111111111101111011100200110222121a2021021102100111111011101111100
111111111111111011001111011011111a11111110011111a1110011001101111001111111011111111111101111111110111101110111111121222021012221b1220211221202201110101110011011
111102102222122120201101221200012a00011111110101a1010101101011111111111110011110111000111111111111111011110111101011002002121111b2211112210021111111111111011111
111120121202211202121122022211122b11000111111111a0110111101111011110111010111101111111110111111110111111011111010112112122022201a1212011102212011111101111111110
011011011112021022020222111101102b01111111111110a1111111101011111111011011111101011110111101111100011111101010111220020222122021a1210221121222111001101001111111
111021111222211211100201212021211b01110111000111a1111111111111111111111111111111111111111111111111101111111111110112102011201202a0210222201110010111111110101111
111112220212001101201100001022211a11110110111111a1111111111111111011111101111111110011101111111111111111111001001022111122221111a1211101011221111111111111101111
101111112021212021210212111210112b11110101110011a1011111111111111110110111011000011110101111100111111111111101110002110211020121a1210122001220111011111101111111
011122122221122222220212111120212a11011000111110a1010111111111110111110110110101000111110111100111111111111110001020221202122122a0101121011111010100110011011101
110022122222021221012221121001120a11001100101111a0111111111111111111111011110111101110111111001111110111111111101012012202110122a2222202212211211111010111111011
011112200211022200201001211222120a01110111111111a0010111111111101110111011010111111111111111111111101010011111101012112121212200a0102201222021201100011111111101
101110111111202012211221111122110b11111110100110a0111110111110101111101011111110011011111101100001111111111110111111011120211212b1222111202102211111111111111011
011021102211111222122111112222101b11110110100111a0001111111001111001101111011111101110111110110111111111011111110002210102011121a1221222201021111111111111111011
110001222011112112120021112221122b11111111011111a0111111111011111111111101111100011111111110111111011111011111111121001222210201a2122221010001111101111101110011
111120210120210120122002210221202b11111110111011a0001111011100111111111111111110111101111101010111011101111101100111111111111110a1111111011111110101111101101111
110122122222022210021020212122012b11111100101111a1101111101111011011011111111011011111110011111111011101111011110111111111101111a1110111111111111111111111101111
010120211001202222101210202220110b11110111110101a1010111011001111110111111111111111111011111001001111001111101000110111111001110a1110011111011111101110101011010
111122111122012211122120121022120a11111111110111a1111110111111111111111111111111111111111101111111110101111010111111111011111111a0111111111101111111100011011100
111111211220021101122120110012212a10001110111111a1011110110111111111111001111111010010111011111111111111111101011111111111010111a1111011111111101100111111111111
111122212011122211221221211212222a11111111111111a1110011111111111110110110111111111011011111111110111110111011101111101110100111a1001111111111110111111111111001
111102211111122022122112220111122b01111011110010a1111110111111111110101100111111111111101011101110101110111111101110111111011111a1110010110110011111111111010111
101101220221120110212021111020200a11111011111110a0111110111111111011101011111111001011111111011011111101110110111110101111111111a1111011111111110111111011111101
001021210021010201202222121221222b10111011101110a1011101111111111111111110111110110110110111001101110111110111011111110111011111a1001111101111011111110111011111
111101111111212122212221012021211b11110111111100a1111011111111111110111100111111111111111011110111011111100110100111111011111011a1111111111111100111111110111011
101111221211001212111021212012212a11111101110111a0111101011011101011111111111111101111011011011111111101111111110110101111110111a1101111011101111111111111011101
111101112111222021121220122121012b11011101111111a0110111111110111101111110111011111111110111011010101111111111111111011101111111a1011111101101111011101111110011
111112201221111211212002110221002b01101111011111a0111111111111001101111011101110111010110100111111101011011011010111101111111100a1111101111111111111111101111101
111112202022011112012122221201221b11011110101111a1011101111111001111110101111111111011111111111101111101101111101011111111111101a0010101110100111111101110111111
111110101012100211000012220000101b11111111101101a1111110111011111111011011111011111110110011111110101010111111011111110011110111a1001110111110111011111110111100
111120121222102211220002021122111b10111111111111a1010111111101101101110111101111010111111111110111111010111111111110111111111110a1101111111111111111011111011111
111112100221111212221121212201002b11111010011111a1101111111010011100110111111010101111110011111111110111111010101011111111111001a1101011101111011010111111101111
111122121212222210022100202112010a11101110101111a0111111111111101111111111101011101111111111110011111011111100111111111111111111a1111010111111110111101110111101
011101110111111101100111101011111a10111111111111a1101100010011101111111111011111111110110010111111111011111111011110111111101111a1101101110111011110111101011111
112011221101112110200222111110111a11110111011101a0111110110111001111111111100011111110111101111011111110101110110110110110111111a1111111111101111111111110111011
102101221211220121121122110011110a11111101111111a1110111111011111111111101111111111111111110111111110111111111011001101111010111a1110110101111001101111111011111
211002110221111222221121111110101a11111111111011a1110110111111111111101111110101111101101101110111111111111101111111111001111011a1101111110111101111110111101111
202121212022021010211211110111110a10110111111111a1111111011111101110111111111111111111101111011111111111011011111001101111111001a1111111110110111001111110111111
001212112121212122111200101111101a10111011111111a0111100111111101111111011111011011011111110110111111111111011111001100111110110a1101010011110111111111011111111
110022201002111221202212111011111a10011100111111a11111110111111111011010111111101111111111011011110111111011aaaaaaaaaaaaaaaaaaaaa0110110111011111111111111111101
bbabaababaaabaaaababb220011001111a10111111111111a11011111110111110110111111011110011110101111111111111111110a111111100111111111111111001110011011111101110111111
10222202112121121112b120011111110a11001111001111a11010110010111101111111111111111111100111111110011000110110a111110111111011111110101101111111101111101101111111
12211021120022211121b220111111000a11011101010111a11101001101111111011111111111001100111011011111111111011111a111111110101111111111111111000110111111011111111111
11112021202221011002a010111111100a11111110110111a11111111111110111111111101010111111111111111110111011111111a111010111111011101111011101111101101010111110111111
12221212122120212101a212011010111a10110111111110a11111110111110101111011001001001010111111100101011110110111a111110110011111111111111011101011110111111111011111
11100212122201112112b101100010101a11110011010111a11111111111110111101111011111111011111111111101010010100111a111001010111101111011111110101111011111011111110111
20220111220220121210a120101111111a11100101111111a11110110110111100111110110111111100110111001111100111110101a111100111101100111111010101111111110111111100001111
21021112112222220101a202111011111a11101111111111a10111011111111111111101111011111010011111111111111110111110a011111101011111111111111111111101111110101111111101
22222012212112202221b100110000010a10111111101111a11111121200002202222210120122121110101111111110111111101111a111111111111011001111111101111111111110111111111110
20021211100111021012a121100011111a10111010111111a11111122212211110111222211212120002211111111111111111101111a010110111111010111101011111111111111000111111110001
22212212111121022212a211111111101a01101111011111a11111111100122112120220022121111201111101101111111111111101a111111111011111011111111111110111101110011110110111
11211111120122010221a122111101001a11111101110111a11101120212111010120210120211021211111111101111001111011111a011111111111111100001111111011101111110110111111101
02212221211120220201a121101111111a11111111111111a00111111222111121101112000210011222110111111110110110011001a011110111111111111111100101111011010011101011001010
01122121112221121122b201111000101a11101101111202a12112220220220111122120212021112220211011111111111110101001a101011111101101101111111110100101111111111111100111
02212112010112122122a112101111111a11110111011122a12220220122112002200222102112110021011111011111001111110111a111111111011100111111111111111111111101110110110101
10112200202122212121b122000011110a11111011111221a11120222002221220212211221221020211110110111111110110111111a111100111101101110111110100111111111101111110111111
22112021121211222201b122111111111a00110100100221b20012001202212221112222221011121211211111111001111111111111a111111111110101111111111111011111011010111111101110
12112211222110021201a222111110110a11111101010221a21021221220220202222222210111122221011110101111110111111110a110011111110111111101111111111111111111111110011111
22111202210220112211b121111111010a11111111110012b21220122221202121022211202210211010201110011111101011101111a101011111101101111111010010111111111001111110111101
11210111022101211111b112011110101a01111111011111baaaaabbabbabbbabbabbbbaaabbbababaaaaaaaaaaaaaaaaaaaaaaaaaaaa111111110111010111111100111011111011011111111111110
11100201110211221202b222111111011aaaaaaaaaaaabaaaaaaaabbbaaababaaabbbababb21122110111111111110111111101011101110111011111111110110111111101101101110111101011111
01120122112221202212a2100111111011011111111112122222120110222022012220000b21110100211001011111111111111111111111111111111111111011110111111101111111111111111111
20012111202010112222a1011022122001202212212012220110212202102012022220122b21021111122101111111011111101110111110111101110111011111111111110111011101111011101111
20120210122221212112a2011120110021221221022010120221212222122222222122011b12110011220111110111010011011111111101011101111011111101000101001101011111111111011111
00110100110001111111a1111102202221010022021022221221222212211212220220220a01221101101100101011101111101111111110011111010001111011111011101101111111011111110111
11111001001111011111a1010110111221100122212101022220202022122222222202222b21001222211110101111111111111111101011110101011111111010101101111111011101011001111111
11010111111101111111a1101102220011202120221112101021221220222222222222220a22122002001111101101011110111110111101111111111111111111111111101011111111111011111111
11011000111111110111a1011102120112021221211012210222022222122112222122120b22211011211111111101110011111011111100111111111100100101101110111011100111111111111111
11011001101111111110a1111122101011222112120022222221122222222212121201221b01121222001011000101111111111011111011111111111111011011110111111111111111100111110001
11111111011111011101a1011111121111021222012222212110002212202002012120211b10221102210011111111111111111001101101111011111111011011110111111000101001011111100101
11111111111111111111a1110121112201221222121122121022022202222212212202222b10220221212111111011111011111011110111110111111001111101011111101111111111111111111111
11011110111110111111a1110110201212222112120200222222222220202201122222222a02121001002110111110111111111111111110100110111111101101011110111111011011111111011111
11111101111111111111a0110110000122211021122122102012222222222212212022022b21122100222010101111111100111010011101110001011111111011011110110111110010101111001111
01101111111110111011a1010112121221221222212211221021221210222212222222221b22022222210111110111111010110111011011111111111011111111111111001111001010111110111110
11101110011111011001a1111100021222010012012201122222221222222222200222021b11222220122111111001111111111111110111111110110111111100110110111111111110101111101111
01111111111111011111a1111011202201212220022112222202222222022222000222122b02222211012111111111011011011000011111111001110111101111111111110111111111100111111111
11111110101111111101a1110110222122202222101222022212122220020102112002202b21010220212111101101101111111110110111011111101011011111111011101101010011111111111111
10111111011111111111a0100122212022022012222110122120222122202022222222221a2222221221211111111111111100101111011111111111aaaaaaaaaaaaaaaaaaaaaaaaaaaaaaaaaaaaaaaa
10111000111111111111a1111122210222221221210022222222222202220202122202020b1212120110110111011111111111001111111110011111a111101011111111111111101101101111111011
11110101111111111111a1111111022220220212222112201220202212210220011120020b2222120011111111011110011111110111111111111011a101111110111110110100111010111111101111
11111110111011011011aaaaaabbabaaabbaaabba12222201020202202220222211022201a0222121101011101111111110111111111111111111011a111110111111110101111110010111001001011
1110111111110111101111111121110120210001a11202012122122221022202010102202b2012221111001111001111010011001101111111111111a011110011110110111011111011110111011111
1111100011110011111111111122210222122111b02212212222021121020212222022222b2002111111011111111111011001111101111110010101a011111111110111111111111111111111111011
1001111110111001101011010111110201210212b22202121212201222202020102221102b0221201111111111011111110111001101111111111111a111111011101111110111111101110111111111
0101111001111111111111101122001220010112a02222210122022002012111110101211b2222221111011111111111101111110111111111111111a111011110111111111011111111111111101111
1100111000111111111011111101102221222220a11020221112122112021122212121102b2102121111110101111111010111001111101111001111a111111111101011110100111111011111111111
1111111111111011111111011011101211221121b10112121122121101212102102102101b2021121111111111111111011011111011110111101011a101101111111110111111111011011111111111
1111101111111111110011111111111221011112b01210212022122020222000120112211b2111121111111111000111011011111110011011101011a110111111111011111111011111111111001100
1111111011100111101110111120102212022012a21212101120222002212122101022122a2112011111111111111011111101111001110110111111a111111110111111011110011111011111111101
1111111111001111111111111122012121221202a12011112112012022020112020021111b1210111111111111111111111111011111110111111101a111111111111111110111111010111111111111
1111110101111111111111111101212001121221a11121212220222220201200012202222b0121021101111111111111111011011011111110011111a111011110111011110111111111111111111111
1101111011011110111110111100122010021122a20211212222202211112202120212201a2202111111010101111111111111110101111110111101a010111111111111111100111111011110111111
1111111111101111111111111111111111111010a01011110120201221211212201202020b1012211110111111111011111101110111101111101011a011111101111111011110111011011011101111
1111111011101110101111111100111111111011a11111111122222212121101122221101b1212111011111111101111111110011011111011111101a101111111110111111111111011011101101111
1011011111111001011100111111111110111111a11111111110211022111202111121221b2120221111110111111111111111111010111010111111a111110111011111100111001110110111111111
1111110111111111111111110110011111110111a11111110000211212122102202212212a1021210000111111111110111111111111011101110101a111111011011111111100111111111100111110
1111111111100101111101101111101011111011a01011111101121122211021122101011b1212211111111101101011111110100111111111111111a101111111111111110111111110111110111011
1101101111101101101111111111110101111111a11001111102111112121222112222212a2100110111111110100011010111111011010111111111a111111111111111111101011100111110111111
1111111111110101111111011111101110111011a11110101112222122001111122210001b1220211011100100111101010101111111111111111101a111111111111101111011111110111111111111
0111111101111110111011111111111111001010a11110110112221111122121011102022a2022111110111111111112222021100112112112201112b212110011101101000111110111111101111111
0010111110111111111101111111010011111111a110011111110aaaaaaaaaaaaaaaaaaaaa0111111101101111111111220221201011011111110102a012211111111111110111111001100101111111
1111111011100100111111010111110111110111a101111010110a111111011111101001111011111111100111001112122011012002110122221220b222111111110111101110111101111011111111
1101111111111111011111111110101101111011a101101110111a110111100111101111111001111111110100111111221210122121222212112011a022111101110001100111100110101011101111
1111111011101110100011111111101100111111a111110111111a101111111110110111111111011111111001111102102112122001201222212122a120011101111101101111111101101111111111
1111101111110111111110001011111111110100a110111010111a011110111110011101111111011001111110111111111010222000221220212202a220201111111111111111011111110101111010
0011111110111111111011111111110110111100a101111101111a001111111101011111101111001110111101101111111112112122122002221011b021111110110101110011011111011110100001
1011111101011110111111111111111111111010a111111110110a111110111111111101101111110111111110111111111120012222200221211222b022211011011111001111111110110110111011
1101111111111110111111011011111111111111a111111011101a001111101111110111110101101110111111111112121112112122222211121022b201211111110110110111111111111111110011
1011111111001111110111011111110011111111a111111111111a101111111111011101011111111101011111111011112222122120211011211102a111211111101001111111111111111110111111
1101110011111111011111111111111111101111a011011110110a111111111010111011110101111110100111101002112011200011212122021122b221111111111111111001100001110111100110
1111111111111110111101110111110110111110a110110111111a111101111111110011111111111101011111011110212112211222120212001202a102111111111001110010011111111111111111
1111111111110111011111101100111111111011a111111011101a111101011011100111110011111111110011110112210122122201212221211212b200101101111111111111111001111111111011
1111111011111011111110111111110010110101a101111111111a111111010110111111111110111111011111011012011121111112110220202112b222111101111111011111111111111110101111
0111111111111110111011111111111111011001a111010111101a111101111110011011110011111111111011011102221122021011211220211111b212111111111111101100110011011111011111
0111111110111111101111111110111111011111a111111011101a011111110100101101011111101111111100010112222212121211022011212220b110201111011011111111111111111111101111
1110111110101011111001111100111110001101a111101111011a111011111110011101111111110110101010010110102212021211021222021201b110211110010111110110011111111101011100
1111111111001111110011111111111101111110a111101111100a111111111111110011011111011011111101111112102000110111211112112211b100211011010111111100001111110011001111
1111011101110010110111111111011111111111a110011111110a111111111011011111111110110111011111111112220121011021011121002101aababaaaaaaaaaaaaaaaaaaaaaaaaaaaaaaaaaaa
1111111110111110111111101111011101111111a001111111110a1111111101111111100110110111000011111110102220222201110122222002120021111111111011111011111101111111111111
1001011101011111111011110111011011111111a111111101111a1001111111010010011110111111110111110101112102021221120221101220221111111110111111011111101110010101111111
