(70,10)
(17,155)
(3,3)
(43,7)
(85,115)
(100,12)
(45,94)
(35,64)
(19,4)
(58,53)
12222122112112021010011101111111011010011100001111111011011101111111001111111111111110111101110110111011111111101111011a10010111a0111aa1111111101111111111110111
12101001120000022211111111101001111111111011011111111111001111111011111111111111111001111111111100100111111001111110110a11101111a11111a1000111111010000011111111
22211212122112011211110111111110101111101111111111111011010111101111111101111111111101001111111001011111101111111111111a01111010a01111a1111110111111111011010011
00001202101222222211111001110110011011111110110011111111111111111111110111000101100011111011111111111110111111111011110a01111010a11001a1111111001110111101111111
00212222212222212221111111111110110011011101101111111111111111111111010010110111010111001101110111110111111111111111011a11111111a10111a1111111110111011010110111
20220202212222212221111111111001110110110110111111001011101110100111111111010111111101011111111110111111111111011111100a11111011a01111a1111111110111111111110100
12122222222200210111111010111111110110111110111111111111001111111111110001100111111111111111010101101111111101011111001a10001111a10101a1110111111011101111111111
01202210222022222111111111111111111111101111101100101110110001011111111111111111111111111111111111011111111011111111111a11111101a11100a1110111101111111111010011
0121012001200121122aaaaaaaaaaaaaaaaaaaaaaaaaaaaaaaaaaaaaaaaaaaaaaaaaaaaaaaaaaaaaaaaaaaaaaaaaaaaaaaaaaaaaaaaaaaaaaaaaaaaa01111111a11000a1110011111111011110011001
0102221101220222122a101111011110101111101111111111001111111111111101111111111110011111111011101001011100111011111011101110011111a11111a1110011111111011111010111
1022121200222222222a101101111111011101011111100111111101100111111111011111111011110111111111111011011111110111101111110111111111a11111a0111111111111111111110111
2112201200222122221a011011011100011100111110011011111011111111111011011111101011101100110100111111111000101111111111011111111111a11111a0001111111111111111110011
0222200221221220221a111111111110111111111011111111111111111111011100101111010101111111111110100101111111111101111011111100111010a11110a0111111111100101111111001
2120212120202212222a011111111111111100011111011101111011001111111010111011111111111111110111110101110011011001111111111111111111a11111a1111101101110111110111111
2222222022222202202a111111110110101111111111111111111110111101111011111111101111100111010111111110100110111111111110101100111111a01101a1111010111111001111111111
0222201212212220021a100110101101011111111111111111011111111000010101101111001111111111101001010000111011111101011110101101111111a01011a1111111101111100111111111
2220022220211220211a111111111011011111111110011011111111111111110101011011111101111010111111111101111111011111101010101101111011a11110a1011111111111111110111111
1211112212000222220a111111001101111110111111111110101111101111111111111101110111110111101011111111011110111111111111111111110101a01111a1111111001111011111111111
2222210110222022110a111111110111111101011111001111111111111111101111111111111111101111111111011111111111110101111111011111100111a11111a1111101111111011010110111
1100200012222212111a11110111101111111110101111010101111111111111011111101110111aaaaaaaaaaaaaaaaaaaaa1110010010101111101110111111a01001a1111111110010111101101011
2110102112121102202a01111111101101111111110111111112212211222012220120001022112a1110110101111111111a1111111111101111011111111011a01111a1111111111011110111111110
2122200002211021120a11111111111111110101111111111211011200222011012212210211121a0111111111011101111a1111111100111111111111101111a11111a0110111111111111111111110
2101022111120111120a10111101111100111111011010111211212210022021101112202101201a1111111111111111111a1111101111011110101011111111a11111a1011111101010111110110011
0121122222120122211a11111101100111101110101111111222120111000101211021210121010a1010001101101111110a1110101011111011110111011001a01101a0111110110111011111111011
2211001121210202211a11011111100111011111111110011112112221222222211222212210110a0111011111000011011a1101010111111110111101111111a11111a1111111110011111111111111
2111211222201122012a10111111001110010110111111111211021111122220211222212201121a1111111111111111101a1011111001111111001111111111a11111a1011111110111011011111101
0111112002011221022a11111111100011111111110111111020210022021220022212222001001a1111111111011011111a1110110111111111111111111011a01111a0111111111111000101101110
0220112110112122222a01111111101111111110101110111220121212212011012022222222222a1111110101111111010a1110111110010111111101101111a01111a1111111111101100111111011
aabbbbbabbbaaabbabba22101111011011111111011111111212122220201122212211222122221a1111111111111110111a1011111111111111110101111111a01111a0110111111111001111111110
1222120222222211222121111111111111111111111111111202110200220221021022111211220a1101111111011011100a1111111111111101111111111011a11111a1111111100111111110011011
2021122112122222221212111101110000111000101111011201010220001222102222211222221b2122222212201010122b1110122101111111010111111111a11101a1011011111111111111011111
2210121022212110121111111011111111111101101111011121222120021220222211110222201a2202222011010122122a1221221211110101011111011111a10111a1001010111001111110011111
2121220022220222122111111010110010110101111111110112120122221212110120201212222b2220212011222212011b1101101111111101101111011110a11111a1111111111111101111111001
2122212200221102122110101111011110111011110111111222021212122101021001122202212b2221111110210111202a0102100201111111011111111111a11100a1101111111010110101111101
0221022211102120012022111100101111110111111111110112220012100010121121122122222a2112112221012012110b1121111111111111111011111101a11111a0001111011111110101111101
0022112220212202011112011011111101111111011111111121121112220212122222122110110b2210221101202222212a0121021011101011011011111111a01101a1111111101110101011110010
1221211212012112101121111111100011101011010101010211222122102210022120212112212a1020012110222121111b0112102011111111011101110101a00110a1101111011111110100111101
0122202101021211121221111111011110110101111111111102222102201121210210101211122a2102210021121021212b1112202121111111110111111111a10111a1010111111111110011011111
0111111220011112100012111111100110111100111111111121112012121111112212201122112b2221220212011220201b2021202101111101111101101111a01110a1111101011110111111110011
abbaabbbababbaaaaabbabaaaaaaaaaaaaaaaaaaaaaaaaaaabbaaaababaaaaaabbbbabbaaaabbaba2201121201220102002a2211221101101101110111111101a11110a0111101110111011110101011
201122210112222111112111010111101111110100110100110201202020111221121120100122111112221210021121122b1211212121110001101011111101a11011a0110111111111111111111111
221120221211222100121111110111110101101101111111121012121022221112220021212012110210111111121222121a2101212201011111111111111101a11110a1101111111101101111100011
012122202122112202111201110011111111111011101101122222110221121111101210202112202102220211211121200b2011000221111111111111011110a10111a1101111111010101110111111
122100220021211100210000111011110110112022102201101210102222012221021112111111211222201102112112102b2112021111100111101010111111a10111a0011110110111111011101111
102202011211202221111011110111111111112110221012122021121212222102210112222212001212012012102121212a0012221111011011110110111110a11110a1010100111111111110011100
110001110210221111110110111111101111111002100121221222211121222122222202201021211111112011222122220a2112112021111111011111111010a11101a1011111111100011111111111
011211002211112111102111110101111111112221212111112200021020122022221120012012001112111110121102201b2102221211111110110110111111a10111a1111101111101111101101111
112222121221022012122111111111111111011112120112122222221122221000221110101211010211110212101211112a2222110201011011100111111111a11001a1100111011110111101110111
002211011110022210110101111010111101112221212110221221222222211020200110022212222120211112122211101a0121001211011101101111011101a01011a0111011101111111111100111
122211111112211221112211101101111101110111122210222202212212122221002222120221010222201211112002200b2121002111101110110110011111a11110a1111011011001111110111011
121001120120012122122101011011111101112112221012112101201211221202211101111111122202010212121122021b0210221121101111110111101111a11111a0111111110111111111010101
002110110221011201101211111111011110112102221212122121212221122011201111111111122121002112221110222a1021211111011111110111111101a11111a0010110110011011101010001
211120112220111021111211011110111111001110220200112012210001202110211111110111121222100122222212112a1201101121111111110101111100a11111a1101111111111111111101101
011102110201221211220210110111011101111122112122211012011221210122111110111111111122111001112201222a0122121201101101110111110011a10111a0101111101011111111111111
122111221101122120211211011000111101112102022000220221111110111010101111111111101110021212012112200b2202112121010101011111101011a11011a0011101101111001110100111
022112022212021002011210111111011011111022022022212000021210211101101101111111102211211211210122200a1221122201111110010110111111a11001a1110111111111110110011111
102110011211022102222111011111110101110011112102021222221111102112121111110111112110222212222111202a1121202100111111111111011111a01111a0110111101011111010111011
121111221111100222112211110111110111112112212111110211112121100202211111111111102112101221020211022b1020110210111101111011111111a11101a0111010111110111001111111
110111111111111111110111111110111011111002122222111222221102221212121111001111101221012221221222111a2022212211111110111101111110a11111a1111111111101111011101110
aaaaaaaaaaaaaaaaaaaaaaaaaaaaaaaaaaaaaaabbabbabaabaabbaaababbbbaaababaaaaaaaaaaaaaabbbabbbbbbababbaab2122211221110111011111010111a11011a1111111110011011011111001
11011110011111111101110111011111011110112221221022121220111111121100111111110110001111111110101101111111111111111001110111111110a01111a1110011110111100111101111
11111011011110111111111111111101111101120220112222022221201220110212101110111101011110111110111011111111011011111101101110110101a11111a1110110110110111011111011
11111100111111111011111011111100111111212222120222121201121201121221001111001111011111111111101111110111011110110111110001111101a10111a1011111011111111111101110
11011101111110011110111111110111111101102222222212102122211202212211111011111011110110111111101101111111111111011011101111111111a10001a1111101111111111111011111
01111111111111011111111110111111111111211210222211210212211220201100011111111001111111111111101111111111101111111111011110011001a01110a0111111111101010111111101
11111111110110111011111111111110111111101011212211110112221221210222111111110111101111111111110111001011101101110111111011110111a10111a1101111111110101111111011
11101111001111111101111011111011111111121111211211022122222021022122011111111111011111101101111011111000011010001010001111111111a11111a1110101001111011111101111
11111111101111011011101111101101011110112112121120222120111210121022001110100110111111111001011010110111101101110010011110101111a11100a1111111101001111111110111
01011011111111101011111111111101101011020120212000120210212122221122111111001111110111111111111111111011101101110111111110111011a10011a1111111111110111111110101
01111111111111101111101011111011110011110222112122112202010110112211111111100111111111111110111111111100010111101111111011101111a10010a1111111101101101111111111
01110101111011110111111111110011111111120202001222022120102112110121010011111111111011011110110111011121222010111011020222012002a01110a1110111011110111111111111
11011111111100101110111111111111011101122022222211121102221101221211011101101111110011011111111111101122121212211100021211210112a11111a1111011111111111101110111
01110001111111111111111101011111001111002202101021111121112122122120111110110111111111111011110100112220111211212112111121120012a11111a1111111011111111101111011
11111110111111111110111110111111110111111001011111111111111101111111111010111010111111101110111111111212221001112220020202022101b11111a1110111111110111011111111
11101111110111111111111011111110111110111101111111111110101111111101011011011111111101001111101111012220010210221202101222021222b11110a1111111111110111101001011
11110111111101101111111101001111111111110111111111011111110101101101101110111111111111011111111111100101122210022212210202221020b01011a1111101110111111111111011
01111111111101111011110010111111111111011110010111111101110111111101111111010100111101110110010111112111202001111021222222222112a21111a1111011010111101111110100
10111111010011111111111110111111111011111111101110111100111101111111110101010111111101111110001111102120102111221201012211111201b21101a1011011111111111011111111
11111111111111111101110111111011111110101101101101111011111111011111001111111101111101111011111011111122221111000222212201121110b11111a1111111011111111111111101
00111011111111110011101111111101110111111111110110111101111110111111111110010111110101111010111110110121122220222222221220211121a11110a1111101111101100110011111
11100111111111111111110111111111111111111110110110111111111111101001101011111011110111111110110101111112102212210012112200120102b01010aaaaaaaaaaaaaaaaaaaaa11101
11111111011101111111111111111111111111111101111101111111111111101010111011000011110110110111111111011022010212121211212102111122a1001111011111100111111111a01110
01111111111111111011111011011101011111111111011011111111111111101111110111111111111101011111110110111222210011221212022112221012a2111110011111110110110111a11111
11111110111101101111101101111111010111111111101111011001010111011111111111110001101111111101111111101212212121211201020211012212a2111111101111101101011111a11110
10011011100111111111111111011111111111101111101011111111111100101011101100011111110101111111111110110121112010222201022011112120a1111111111111111111011110a10111
21212022102222121121212122210111111101001111111101111101011111111111111011001110001111110110111111012200102122210221120001111021a1010101101111111000110111a11111
11011112112222001011102221011111011101010100111101100011101111111011111011111001011110111001110111100201122110110121120110222100a1111111110111110111011011a01011
12221211111101102121212210010110111111111111111111101111110110101111111111111110111111111010110110111222122222100210021121012120b0111111110101101011011111a10001
10022112122112221212211221211111101001110011011111110111101001111101111111011100101111111111111011011222121212121211211111120220b2110111111111111101111101a01111
12020101112101220101111111211001111110111111111000111111110111100111011110101101111101111111111111111210000110111212202201001112b1111111111110011111101111a11111
10111120002022210211220111011111110111111110111111111011011111011110111001111110110010001101011110101120102212201022212220212100a1111111111010111111000100a11010
10112211211122021112012202201111111111111101011111100110111111010010011011111001010111111011010110002021210121021221221211122222b1111111111111111111111101a10111
02212012021221211112202212211011111111100101111111111111111111111011011011111010101011111101100011102121221212200112111200221111b2111011111111111111111111a10111
22221212022021012211212112211111100101111111001110011111011111101101011110110110111111111101101000111212211101112121210201111220b2111111111111101100111101a10011
02202111210101021201202101211011111111111110000100111111111101111011000011101011111111111111101111011211121221122111021101101210b2111111110110110110011111a11011
21221201112100200111222012101011111111110011111111111110111111011001110111111101111101111110011101010122222101121122121202122012a2111111111111111111011011a10111
01121202101211011221210221211101100011101110111111111111100110011111111111110011111111111110100011112122010222120210220122221212a0111010111111111111110111a01111
21122222001112221201022111111111011111011110101111111101111111110111111111101111111101111101100111100000211101201222101220220112b2011110001111111111110111a11110
22211021121101222201022122211110110111111111111111010111111101111110101101111111111010111001011101011200221202222112112210221212a1111101111111111101111011a11111
212121011021202102222011121111011111111011011111111111111111101101111111111111111111011111111111100110222200baabbbbabaaababbabbab2111111111111111110111110a11111
222112222220210211212211022101001101111111111011111110111111110001111011111111111111111111110101110111110111a111111111111111111111110100010111111111111111a10111
110221010112020110222211222101111011011111101111011100011111111111011111110011111111111111101011101011011101a111111111111011110101100111111111111111111111a11111
110111212122112122212122101111111111111110101101111111111110011111111110111111111111110111110011111011100110a011011011011111111011111111111101110101111111a10011
200012212112210211111111120011110111001111111111111111111101111111111011111111110010101111101011011111111111a110111111110111111101110111111101111111111111a11111
222211211221202112221211121011101011011111111111111111111100110111111011111110111110111111011111111111111011a101010111111111110111011110110010111111111111a11111
121221112122121102202221222111111011111101111111000101111101110111101111111101101110110111111111101101111011a111111111110111101111111101110011101111111110a11101
221112111211120212011210020101111111111111111111101111110100111111111110101111110111111111111011111111111111a111011111111111100111111111111111011111110101a11111
122022221211212020222200102111111111110100110111011010111010011001100010001111111110001011011111111011101111a110111110101111111111111111111111111111101010a11111
221101200212012102201221021110101111111110111111111111111110111111111111111111101111111011111111111111111111a101111111111011111111011111111110111011110010a01101
220101120212211112202102211110110111111101101111111101011011001101111101111101111011111101101111011111111101a111010110110100111100010111001011101111101110a11101
000012000221101222002002012111111011111010111001111101110111110010101101110010111110010111101101011111111111a110101100111101111111111111001011110111111110a10111
122221222020202221022202112110111111111111111110111111111111111111101111111111011011010101111011111100111101a111101111110101111111111010111111111110011111a10111
211220012122202122121220112110111111111111111011110111110100110101111011011011111111110111111001111101110011a111110110011111111010101111011111011101111101a11011
222022202101221122021112221110111011111110111111111111110111011001101111111110101111111110011111111010111101a111111011111101111111110111111010101110100001a10101
121120101121221112121110022011111111000111010110010111111010110011111111011101111011011011001111010110111110a111101111111111001110111100110111111111011111a11101
111011111101011111111111111101111110010111111111111110111111111111110110110101111110111111111110011110101111a111111110111111111110011111100100111011111111a00011
111101101011001111101111111110010111101111111110111111111111110111011110111011101111111101001111011111110010a111111101110111111111101111101101011111111101a11011
001110011111110111111110111111101111110111011111101011101010111111111111011110111101111011111111011111100111a101101011111111111000011111101111110111111001a10101
111111110111111111110101011010011111101101111011110101111111111011111001111111010111111111101101110100101110a111011101111010110011011111111111111001110000a10111
111111010101111011101101110110111101101111110111111110101011101111101011111110011111111111111011101101101100a111110001110011111111111111111111101111111011a11111
