(115,147)
(6,145)
(44,112)
(17,72)
(112,1)
(60,142)
(47,158)
(35,43)
(34,20)
(38,33)
11101111110111011111111110111111111101111111101111a1011111111011111111111111011111111111111110111111111111111011111111111110001111011110111111110000100011111111
11111111001111101101011110111110100110010111110010a1111110011111111011110110101111011111111110110111111111111111111111110101111000111111111111101101111101101111
01111100111111101111011111011011111111111111111011a0111101222221110022122201121120120201111111111111111111111110101111111111010111111110101101111101101111111010
00111001101101101011111111110111111111111010111011a0111112202011220112121121112121211110011111011111111101111111111110110111011111111111101111011101111101101110
11110101010101110111111001110111111111110111110111a1100112122112220201111121101111011101001111111111101111101111101111011111101111001111100111011110111111111111
11111110110101100111110110011011111111100111111111a1111011201012111111112220122221002220110111011111011010111001111111111111111101110010111011101110101110111101
11111111111011111111111111111100111111011111010111a1111102211112212201112222221222112121111101011110111111111100011111110111111111101111111111111110101111011011
11011111110001111001011111101111001101010111110111a1111110212122100102211222212110120111010110010111001101001111011101011111110111011101111101101111000111100101
11111011111111111101110010110101110111101111101111a1101112211201122222221111211122122111110111111111111011111111101111100111111111111111111101100111010111111101
10111101101111111001110110111111111111111111111110a0111010212212211121211200021020100221111101111111101011111111111111111001111111111110100010111011111100101110
11011111111101111111011101111111111110111111100111a1111111212121221112201120112122221110111000111011111110101111111111101111110111111111011011001110111111111011
11110011111111111101110111111110111110111111111001a1111112121102021211120212221201221211110110111111110111111111111111011011101111111100111111011110011111111011
11010101111111111111111100111111111111010111101111a1101110112212122002022110221010111211111111111011111111110101011111101011111001111100111101111110110111111000
11100101111111110110111111111101111110110111110110a1101112112121121121111111210211112111110111001111010011101011111101011101111110101011111101111001111000111101
01011111001100111101101101101100111111111111101111a1111111200210101122101110121112021111011111110111111111111101111011111111111101111111011111110111011110111111
11101111101111111110111111111111111111111101101111a1111111222112122212120121012201221111111110111101111111111111110110111111100011110110111110110111110110111111
11111111111110101111111111111111011111111001111111a1010110212111221010112210221011222111111101101111011101111111010111110111111001111011001111100110111111110011
11111101111001011111110110001111111110011011111101a0111112011221021122201120020201222121111101100111111111111111011111111101101111111111111111111110111100111011
11111011110111111101111110111111111011111111011111a0011002122022112110022111122210022220111111010110011111110111011111111110101111110111111111111011111111111011
11111211212112202111112200210120111111111111101111a0101112201122121221220112120110102220111110110011011111011111100110010001110011111111111111111110010111110111
11110211211121112122210211222202122211111211121221b2122020202210211121011211001121122211110011110001111111100110111111111011011011101011111111101010111111111111
10111202120022101112110110202212022121111121200222a2022120022112211121022111122122101100111001111001011111111111111011111111111111011001111011101110111111111111
11101012212201202101111111102202222021121210202111a2101122201021100122210021221010210121111111010111111111111011111111101111011111111111111101111111111011111011
11111212221210212222222220212212221212122212222112a1211222111221122122121122020220011001011110111111111110111111110111010101101010111110111111011101011100110101
11101121220012122101222221211022221222002102222212a1221201110220110110120110100011012021110011100011011011111111111011101111011011111111110111111111111111011101
11010211012121111122102010222122202021120021222122a2111021100110100120020111221112022111101101011101111111111011011101110011111111011111011011101001101101110111
11111021221212211000212201201222202222221222122222b1122100222222010111101111222002012111111111111111010011110100110100100110101011111111101000011111111111101101
11110211212121220210221201222121222222221222222222a1221022120010112020222100100110112201111111010111001001101011111101001111111111011111111111111111100101111111
01110101222112102111112220220222002211022211022221a1002220211111012021021212111212220121101111011101010001111111111111010111111111111111011111101100111010111110
11111000012202011220212212212212221122120122012011b2120112112112101201201201112011100110111011101221212021221111210121210211102011111111111111111111111111111101
10111122201222111122211012020221210222022222220002b0202100212222111121211212121112122101111010111201201220010120111001111212121110011111101011101111011100011101
10110221112121120001120020020222120222221220222212b2011121222211022021210211212212110001111111010222022212222021022101112221122010111111111010110011111111111111
10011011211222222002022210222202201121121222210201b2212212001011101101111111110010100111111101111122111021221212222221222121111111001011111100011001211221122012
11111210010112211221122112020200120221010012112011b2012121111011111111111111111110011111111111101221122222221100221020021110220001111110110011101122120222222222
10110201121022121010222222112211022210202211112121a2220211010111111010111111011111111110111111011102122222010121121222110121212101111111111011111212101210221122
10111210111110221002201220202222212212200122222011b2021000110101111111010110111110101011111111111211211121201212222121120222222111111111110111121202121102201011
10111211122121012122212222222022220221112021200220a1102121110101011110110111110111011111111111111112011222221222121012100202212111111110101111021220201221222122
11111211110102121222112222120202021121020212222021a1222120101111110011101111111111011111011111111221122021212111102121121011122111111111111110000122011121211121
11110221112112102222112201022022202110222122220212a2021112110110011111101011111111111111101111111101120201112211222222211210122011111111101111112101102122110111
10011112212101212221112222102222222020101211222011b0222120111110011111111101011110001110111111111221201012020111002222121122111111111111111111112221202012202221
11111111210111122222122020122222002112222212021212b1110202111011111011111111010111101111010011101112221112011111002122122012111101101101111101021101221010112000
00111211221221212122222220121221222000012221202220b2111011110111111101111110111011111110111011111020101102120222102222201010112111111101110011122221102110112102
11111211211221110022222200210220021122021102122011b1111120111011101110111111001110100110101111111221111222220201020112121212202110111011111111020112110211122122
01111111120210210101212222222020122212001212210212b0121021110101111111110101111111011111111101111112102221222121221102011020202000111101011111120221021021121212
01111122102121111222222022222222212002221202022021b2021110111111101001011011011111011011101110110111100110212122221221120201012011011111110110002120202011121221
11111110021112201202221200122002222212222112211100b2122012111111111111011111111111101111110111111110111010122112102122120121022222200212211212201122222122112111
11110222011210222221201222222220212012202221022011b1222212111011111111001110010111111111011011110020111211102101111222002221212200001002122121111221220022121022
11111222221210021022222220020222222222221121222212b010112201111111111111111001011111011111100111110110120012100111122102abaabbbbaaabbabaabaaabbbbaabbbbbbbbababa
11101112112122121122101101222222221210100102122221a222011111001010110110111111110101111111111011021211111211122221121121b112122020111112011102022221022111202220
11110011011001110121121211222222222120220210202222b201221211101111111100111101111111011101111011121000211202212102021221a221112222121112221220101220212222200011
11111111111111001110121122021212010021222022112110a111111111111111011111111111111111101011111111112021101102210012121122a222110021121111121100222212101222111121
11110001111101101112212101021222211112212122101211a111101110110110101011111101111101011101110111101221012100111011110220a110202210202112210002111222121120222222
11111101111111111120121121002111211111102202101111a111111010011010011001000111111100111110111111110220222110211222001121b120012111010122220111121121220122110112
11111111110100110111111111011111111111010011101111a110111010001111100111101111111111111111111111122211012121212212122012a212012120210201212220222022222221122211
11111101111101111101111110111111110010111111111110a111101001111011101100111111000011111111111111111222221012202100222110a211122221212222102021202202012222021122
11111111011010111110101011111111111111111011010111a111101011101110101111011111110011111111001000122101220211201212122020b112101222111202111121020002210102020212
01111111111111111111011110111111111111111010111000a111110110111111111111111101111110111111011100112111111200122011011211b210022221222211211212222222220112220121
11111111111101111111011101111111111111111111111111a111111111110011101111110011111011111111111101110222102112221101122012b111202222201211221221202220202212112222
11000100111111111111111111000111110111101110101111a011100100011011111111111011111100110111111101110112220011022221122221a121012212121112211221221122221212200011
aaaaaaaaaaaaaaaaaaaaaaaaaaaaaaaaaaaaaaaaaaaaaaaaaaa001111110111011111110111101111011111101101101111101100111111111011111a111011121102221112002222220222222222222
010111111111101001111111110101011100101011011111111011101101111011101111111011011110101111100111001110001110111100111111a100111222211201222122122112021020122201
011111111110111111111111010101101101111101100111111110111100111110101011110111011111111011111010101111101111111000010101a111111112111210221102202112122212122211
110111111111010111111011111111111011111111101110010010111111101101111011100011101111111111111111011110111111110111111111a011111201221000102210202021022102122111
111111101111101101110011111111111111011101111100011111111111101111110111101101111101111011110111011101111111110011111110a110111011202112010121101222112202222010
111010101111111111011111001111111111011011011111111111110111111111011101111110110101011111111111111111110111111001111111a111111110200202121111212012222121200111
111111110111111111111001011111111100101111111111111011111110110111111111011111011011101111010101010111111011011111100101a111010100222122111021022211112212101011
111111100111011001111111111100111001110111101110011111101111011101001101111111011111010111101111101001111011111101111111a110111220022102120120020221122221212111
111101101110111111001111111110111111011111111111111101101111111111111111110111011111111111110010101011111111111101111010a111111100220111211221012021121222112111
101111111110111111111111001011111101111111111111110111101111111111100110010111111110011010111111111110111111110011111111a111011101121122110201222112211211021111
111111111111111011111001101000110011111110111011111111111001011100111111111111111111111101111111111011110011111001111011a111111222110201212112211120212102210101
011011000100011011111001111000111111011011111111111111111111110111111111111111110101110111101011111111111111111101101111a111001122002001112121002020022022122111
100111111110111111111110111111111111011111011000100111111011111001110110101011111011101111011111111110111011010111011101a101111011210221210210102121220112211111
111011110101011101011000110111111111111100111111111011111110111010101110101111101111100111111111111010111111111100111111a101111121110222101122122102222112002001
110111101110111111101011111111111111111111111101011011011111011111011111111111010111111110100111110111101011111011011111a101111002212211211101122212200020211110
000111111111111110111111110100011111011111111110101111011111101101111010111111110011111111111111111111101101111111111111a101010201122012211201122222102012212111
111101111111111110011111111101111101101111111110111101110110111110001111001111111101111111111101111111111011010110111001a011111111111100111111011101111011110000
111101111111111111101101110111011111101111111111001111110111111111111111111110011111111010111111011111101111111111011101a110101111111011011110111111111100111011
110011101011011111011111111011111111001111111010101111111111110101101011111111110111111111111011111101011101101111111111a111011111111111110111111111001011111101
101011111101111111111111111100111011110111111011110111111101110111110111111111011101011111011111011110101011111111110111a111111111111111011101001010111111111111
111110110111111111000110111000111100010111001111111111111111011111111110101011110110111110111111011110011010111111110010a111110111111100101111000111001110101111
aaaaaaaaaaaaaaaaaaaaaaaaaaaaaaaaaaaaaaaaaaaaaaaaaaaaaaaaaaaaaaaaaaaaaaaaaaaaaaaaaaaaaaaaaaaaaaaaa11110111101110110111111a111101011011011011101110111111100110011
111111010111111011111111111110111011111111111111011111010101101111110111011101100111111111110111a11011111111111101011010a111001011111010111111111110111101111111
111111111110111111101111111111110011111111101011010111111011111101111101111011011101111111001011a11111111111101011111111a111111111111111111011101111110111011110
111001111101001111111111111111101110111101011110101111110110111011111101011111011011111110111110a11111011101111111111111a011011101111111011111111111111111110010
101111111110111111110110111101010110111111111101101011111101101111011101111110111111011001111111a11111010011101111011111a111101101110101111010111111111111110111
011001111111111100011111111111111011111011111111111101111111111111111010110101110111111111111111a11111111010111011111110a111111110111111111111111111010110111111
111111011110011101111111111111111111101110010011111111110111111111011101011111011111111101011111a11111111110011111110111a110010011110111111111101111111111111110
111011111101111111011111111111011111111101111111111111100111110111010110111011111101111101101111a01111111001101100110101a111111111101111011111011110011111110111
111111111101111111110111101110111101011011111111111111011110101111111011100110110111001111110011a11111111111111111110011a111101100011111111111111111010011011011
111111111101111011111111111100111111110111111011111101100111101111011101111111111111110111110111a11111101111111111111110a111110111101101111110111101111101111011
111111011111111011111011011111111011110111111011111011110110111111011101011111111111111001110111a11011111111101111101110a110111111101101010111111110110111111011
111111101011111111111111101011111001111110110111111111111111101101111010000110110111001101111001a11111110011011110111111a111101111111111111111111101100010111111
111111101101010110101111110111010111111110111111011110111111111111011011101011111111101111111101a10011001111101100010111a111110111110011100111111101111010111110
111111001111100101111011101011111101011111110111101011011111111101111011111111110111101110110111a11100111100110111111011a111111111101111111111100111110000111111
111111110111001111111011011111010101111011011111111011101100011111111111001110110110111111111011a11111000111011111111011a010101110111011111111110101101110110111
101100110011111010101111111100111111111111111010111011100110101111110111101111100111110101111111a11110111011111011110111a110110101111111110111111011111011111111
111101111111111111111111111111011111010111111111111111111011111110111111111100110111111111111011a11010111111011110111111a101010011111111111111110101011011101011
220222102220012111111111000010111111110111111110011111111011110110111111111111101111001111111111a11111011111111111110111a101111111111111111011111101110101111111
012021122201102211101001111111111111001111111000111101001110011111101111111111101111111111111111a01001111001111011011101a111111111101111111101111111100111110111
012122010210121201111111011110100111011011111111111111111111111111011111101111110101111111111010a11011111101111110101011a111101111111011110110110111001111111111
0020aabaabaabaabaaaaaaaaaaaaaaaaaaaaaaaaaaaaaaaaaaaaaaaaaaaaaaaaaaaaaaaaaaaaaaaaaaaaa01110111011a11111110111101101111011a111111011101111111011111011111111111110
1211b2110010122110111011101111101101011111111111010111011111010110111111100110111111a11100001001a11111111000101101101010a111101101111111111111000111111101111111
2121a2211121112111110111111110111111111011110110011111111011001110111101111111111111a01111101001a11111111111101111111110a111111111111111110011111111110111101001
0112a2112201112211111101111111011111111111111111101001011111111111110110111111111011a01111110101a11111111111011111110111a111111111111101111111111111111111101100
1112b0201112121111111101011011101101111101010101101010111111111100110111101111110111a01111111111a11111111110111111110111a100111101111110100111111111011110111111
2021b2012002122111101111011111111111010111111100111111111111111111111111110011011111a11110001111a10101100111110111011101a111111101111111111111111111011110111100
2001b1012120110211111011000000101111111111101111111111111111011101110111110001011100a01011111101a11111111111111110111110a111101111111111011101111111101111111100
1122b1122202112201110111101111110110111111101111110111110111011110110101111110110111a11011110111a11111101101111101110010a001011001011011011101111101111001110100
2120b0222212021111101111111111001110110001111111111110111010100111001110101011111111a01110111111a11011110101111101111011a110111101101111101110111000101111111111
2112a1112101122111010101111110111111111111111111111111011111101111111111101011111111a11111011101a11111111111111111111111a011111010111010011111011111101111101101
1211a1122121002211111101111111111111110111111111011111101111111101111111111010111111a11111111011a11101111111111111110111a001111111110111111011011110111111111111
2101b2112221221201111111110111101010111111011110111111111011111101101110110010011111a00011111101a10111101010111111111111a010111111111111111111110111001111101111
1112a0111011221201111101111111111011111011111000101010011111110110110111110110111111a11111111101a10110110101111111111011a111111110010111111110110110111111111011
2111a2010121001211111111111111011111011101110101011110101111001111011010111110111111a11111101111a11111011100110110111111a111010110111110111011110111111111100110
0121a1201221112011110111111011111111111011010111010111111111110101111111111101101100a01111011111a11111101111101101111111a111111111111110011111110111011111101111
2210a2222010112101111111011101101111011101111111001111111111111001111111111111101111a11110011111a10110111111111110011101a111111101111101111011011111001101111011
0212b0120222211101111110011111111011101111111001111111101111010111111101111101111111a01110111111a11011011100101111011110a011111111111101111111111110101101111001
1022b2111111021111110101011110111011111101011111111111100110110111111111101111001111a11011111101a11111110111111111111111a101111011111010111110100111001111111110
1121b0222100021111111111011101111111101011111111011011111111110101111011000101110111a11110111111a11111111100111011101111a111111111111111011110111111111110111111
0212b1121112211111110101111111011111010111111001111111111111111111101101110111101111a11111110111a11111111111111111011111a001111111111110111110101111110111111101
