(99,132)
(38,14)
(67,57)
(16,32)
(57,66)
(72,30)
(3,117)
(11,128)
(16,9)
(118,82)
101111111110111111111111011111111011111110111110101111011110111001111111111011111111011111001111110a11211112101210120222202a221222012111112b02011101111111111011
122121111201100222002222201011112212221222200211101111011111110111011101111111111111111011110111100a11020210012200222002102a212022101200111a10111111111111011111
101112102021011222222222221212111011021211222220011111110111110111110111111010011110111111011111111a01111120111210022202220b212222210220120a10111011101110111100
221002111201222212012200022222012111222212220221101111001110111111111111111111110111111001110111111a01100222102012210220212b122022220122221a12010111110100011111
211122012210221102102022010120111221122012110021111011111111101111111111111010110111110011111111111a00101211122212222221220b212020202112122b21210111011010111111
211220220012112122112220122210111010111202211111011111100100111011011001111111110101111111111111011a11212222212220022121020b222212201221200a11011011111111110110
111021010020221002102121102100221112220200102121101111111111111111111000110110000100111111001100101a11201201222222222222221a221222212222102a02201111111111110111
012111212110212210222101110120211121221222121221111111111111101111111011011111111111111111111111111a01222121211110222201011a200222022002002a11001110111111111111
221212112200012112220202122211212211002012222211111011101011111111111110111011101101011101111110101a11111211222110222102012b221212102201111a22211111110101111111
120101202220211102222222022122121221112221021021011111111101111011110111101111111101010001010001111a11221202022011022200210b222122022221111a22211011011101111111
202121011121122211221011221022111120212201021021101110111110110101111011111011111011110111011111111a01121022210002220222021b222022221200221b12211111100110111101
222120222212110111221221212100212020020010121021110111110001111111111111111111101101111101111111111a11222110211012020021220b202212221120121b22201111111111011111
222212111112112222212122210202222101001212111011101011111111111111110011101111101111101111101111111a10221201112202222210122b202220211212021b11011111111011111111
102220211002012101202220201121121122221111020211111101111001100111111011001111111111111101110111011a01111220221122021222122b210212111002001b02111001110111111111
120011120111201120222202221212201122121112212200111011101111111110111111011110111011111110111111111a01222220110110221222222b022212022210021b22210111011100111011
110222222011112212022201122112101010122122212211111101011111110111100110111101110111111110111110101a01011101211112222202102b212122002121211a12211111101101111101
211200122012112122222021122201211101002222021111101100110111111110111111011111110110111001111011111a11021200121202002222222b222222020021022b12011010010111111011
221121220220101120222022212122112211200010111121111011111111001111111111111111111111011111111110101a11220101200212222202121a122121021202111b02111111000111110111
100222122102211022221222112201112211111202222120011101011101110011111111111011111111111101110111111a10011111110111200021012a002011210122112b11200011111111111110
221022021210020212021222112121112211111101102001011011011111111101011110111111111111011101111111111a11011111101111211122112b002111120102122a22111111111111111111
010212120121120111012001121212112221211000221220101110111111111111111110110110111111111111010111110a10111111111100122122212b111001112000212a12211111110111111111
221221101022022211221122221210211121200112212121101110111101111110111111100111101101111010111111101a10101111111112021022121b011022111201022b20101010111110100111
211122120011202012212210121120112121101111120001111110111111111111111011100111111100110001110111111a11010111100012111211212b212111222111112babaaaaaaaaaaaaaaaaaa
211010211120110212222222121222212221111222221211111111011010110110111111011100011111111101111101111a11111111111001121112111b200121121000121bb2210111111111111111
212222101122222212201102210202210110001202121221111111011101111001011101110111111111111111101111000a11111110111112021222111b102221211121002aa0111111111111111111
221120222022222212222212211210002011222122221020110111110111111111010101111111111101011011101111101a11111111111111122002021b012222122201022ab2011011110111011111
121102222112100222112221200121120222212211011211111111111111111111111111111011111011111111111111111a10111111111101111111101a101111001111111aa1111111111010011011
211101211202020022221020121121012001022022121111111111101111010111111011101111111101011101001111111a01011111111111110111101a101111111111111aa0110001111011111111
100100110221220202200102121011201201021021022111111001111111101110011110011011111111101111111111011a11111111111101111111111a111101111110010aa1111111111111111111
220112111211202222221220211011112112222122022021111111111100110111111111111111110011111110010101011a00000001011010111111111a111110111111101aa1000111111111011111
122020222212122111222121120221121212121210210211111111111111111101101011111110110001110111111011110a11101111110111111111110a110100011110110aa1111111100101101111
111001111111111111000111111111111110011011011101111011111101011111111011101101101101001011111111111a11011110111110111111111a111001111111111aa1111110111110011011
011101101111111011111010111111101001111101111010111111011101111111101111111111101111111011011110111a11011111111101110111111a111011110101101aa1011111000001111111
111011110101111011111101011111111111100011111011111110110111010101001111111110111111011111001101111a11111001111100100011111a111111111101111aa1111111101100011110
101110110011111111111011111111110111011011011111011111110111001111100111011101011101111111010110011a11111111100111101111001a100101111111110aa1111101101011111010
111110110111111110101101111111111111110101111111101111101111110111101001111111111101111111110111111a11111111111111111111111a111111111111011aa1111011010111110111
110011110110111111011101111111011111111010111111101101110011101101101101111101101111111111111011111a11111111101111101111101a111011111111011aa1110111111111111111
100111111111101111110110111010011011111111011111111111111110111111111011111011111111111111111111110a11101110000111100111111a011000111001010aa1111011111011111111
111101111111111010011111111111111111111111111111011011110100111010110111101111111101111110101111111a11110111111111111011001a101111011111101aa0111111111111111111
001111111011110110111011101111111111111110111111111100000111100101110110001111111111111101111111111a11101011010101111111111a111111111111111aa1111111111010111111
101100101011111111111101111111111101110111100111111111110101111011111111011110111110100111110101111a01110111110111111111111a111011101011110aa1111101101101110110
111011111101111111111111111111011101101111111110111111111011101111011101011111011111111111111111111a10111111011011100111111a111101111111111aa1010111111111001110
110111111110111111101111111101111111111011101111111221212111111212111112122021212111011111111101111a11111111111111111111111a101111011111101aa0110111010010111110
011111111111111110111110111110110110100100111011011110112111012121122011121211101111101011111101111a11111110111101011111111a100111111111111aa1111011111100101100
111011111111001110111101111110111101110110111111011002112112102112122200121102101111111010110111111a11011011111111111011011a111111111111111aa1111111010111111111
110111011111111110101111111111111111111110111101111111211022121221221201201211022101111111111101111a11111111110111110011110a011010110010101aa1110111111101111111
110111001111011111111101011111111110001101110011111120111121102110120102222222100110100111011111110a11111111111001101110111a111111111101111aa1111101111111111111
101111111011111111111011011111101111101111111110101121210001101212122221100222022101111111111101011a01111101111111111011010a111111111111011aa1111111111111011101
111111111110111111111111111011011110110101111111111102001110222220110222212202122011011111011111111a11111110110111011111111a111111111100111aa1011111111001110111
110111011110011111011110111111011111111011111111111212121122020110121200222101112011111011111101111a01110110110111111111001a101111111101001aa1111001110111111011
110110111111111111100111111111000111110111100111111221211022111122121222020111221111011111111111111a10100111111111110111111a111111111110111aa0111101111100011111
111001111111111111101110011111010111100111011100111201021101020222101112111121111111101111111111101a01111101111101111111101a101101001111111aa1111111100011011001
110111111101111111111111011111011011111111111121012200011111222222012022121000200110101101101111111a11111011101111101001101a111110011111111aa1101011110111111111
011010111111001100111111111110011110101111022012222000002212121022201110112211221111110111111101111a11110111111001101110011a101011010001111aa1110111110111011111
101110111011111011111100111111101011110111120002210220122220002222121122021021201111111111101110011a11100110101110101111111a111111011111101aa1111011101101111111
111101111111101101010011110111111101111101122202101220211222002022221202002221120001101011111111011a11111111111011111111110a111010111111111aa1111111101111111000
110001111001011110111111011101111111011111212100102112020202122221222212011112111111101111111110111a11101111111111111100101a111010110101101aa1111110111111111111
011101101111011212100010011110122221202210122222122020212220220211221020122012211111101110111100111a01101111100001101111111a111111110110011aa0011111110110111011
011111111111111111022221000111210212022210222111211222211222220212122221211011212110111111111111111a11111111111011111011111a101110111011111aa1111111111011111110
111111111111011120121112211112221120111211112110112222222222122222222220211201212111111111111111111a11111111110100101111111a111110110011111aa1111011111111111111
111111111011110000111210011121110210100021221120200012221220121211102202012112111110111111011111110a110aaaaaaaaaaaaaaaaaaaaa111111111111111aa1111011111110110111
111011101011111020122202022221212202022212122211101021122012211222012122001110112111101010111111011a111a11111111111101111111000111110111111aa0101111111111111111
110111110110101022122022212111011222221210200222121222002120210120221222201212200110111011110111011a111a11110110111101001111011111111111110aa1011011111101101100
000111111111110221102102210022100021100122222112221221022020222122222020011211121011011000110100111a010a01011111101111111111011101111101111aa1111111011100011111
110111111111101012012210221121221122212222212020102111220202202002212202112211021111111010111110101a101a11111111111111011101111011110110011aa1111111111111110111
111110111100011122212111102101112202212222212102101002002222210111112120111211011111011111110111111a111a11111111111011111111111111111111011aa1111110111101110111
111111110111110021212110102211111111111211121121220120211221112122222221212211122111111111111011010a110a01111111111001111111111111101111011aa1111001111001001111
111111111101111201101211201120010220001200022122122222122121122210022222110222112111101111111100110a011a11111001111110110111111111001100000aa0110001011111101111
111111010110010112021201111111211212011222222220201221122222222122020021012022111111110111111011110a111a11111111111111111101111111111101101aa0111011100011110011
111111011111111111211221022021010012221220211021210222202220222122221020220011112010111011001010101a111a11111111011111110100111101101111101aa1111101001111101111
111101011111111222202110212211002121121121202102002101220122122222102220221122020111111111111111111a111a11100110111111110111101111111111111aa1111111011110010101
101111111110111022101221220122211101202221211121112222102202112220222102121212221011101111100101111a111a11011111111000011001011011111111111aa1111111111101110111
110111111111111210000221212010100211012000111212001000211222100211201000111110111111110111011001111a111a11010101111111111101110111101001101aa1111011110111011111
101111010111111122002222121222012211101202101212121221212222221111011010111111001011111111111101111a111a01110111011101111110101110111011111aa1101111010101111111
111111100111110101211120022122222210121210222112110221121100212122122221110111011011111111111101101a100a11111111111101111111111010101110110aa1111111011111101111
111111101111111121201112102102221211010210020022121211221210212101122202111001101111101111111110111a110a11111111111100100111111111111111111aa1101110110011111011
111111111101011200112212122021201222000120222210222222222011221011020211111011011111111111110110111a011a10010111111111111011101101111110100aa1000101111111111111
111111111111110221122122022212212210100212102012102101102222220221212110111011111110111111111011000a111a10111011111111111011111110101101101aa0111001110111111010
110011111111011120221111210221210011221222012210022102110222221012221102101101111111101011110010111a111a11011111111101110111110111111111111aa1111111111111110111
101111110111111111212202122220111111221001102112211210212112202112211112110110011111111110111110111a101a01110111111111010011111111001111111aa0111111101110111101
001111100111001101201111220112210112112010221202120021022102112012002221111111111011110101110111111a111a11101011111111111101111000110111010aa0111111111111010100
111111110101110220211121110212110010010222122100111222101122221121202100111111111110110110111101111a111a10111110100111110011111111110111101aa1101101101111111111
011010111101011102112022222211102001111210211011111100100111111110111111111111100111111111110111111a110a00111111111110011001101111100111110aa1001010111111111101
100101111111111110112202202220112022211100120111011111101011101011111101111111000111111111101011111a111a11110111111111111111111011110111111aa1110101101111100111
111011111111000111022222200212121022022221201111111011111111101011111101111111101111111111111111111a111a11111011111111111111111100111111111aa1111111110111111110
111011101111101012011122111210112212222120002111101110111111110111110111010000111111001011101111111a111a00101111110111111111111110110111010aa1111101111111111111
111111111110110001212002211222012221112221020111111101110111100111110111111111100010111010111011101a111a11110111111100111111110111110111111aa1111110100111111111
111011101001111111110111111110001111011111111111101111101110101011111111111111011111111111111111111a101a11101111111101110110011110111110101aa0111000001111111110
111111111111011111111111111111111111010011111001010111111011111111101111100100111111111111000111101a101a01011111101111010111111111111111011aa1010111111110011010
101111100111111111011101111110110110111111101101001101111111111001111111101110011111011111111111110a111a11110110111011111110111111101101111aa1111101100110101111
aaaaaaaaaaaaaaaaaaaaaaaaaaaaaaaaaaaaaaaaaaaaaaaaaaaaaaaaaaaaaaaaaaaaaaaaaaaaaaaaaaaaaaaaaaaaaaaaaaaa111a11111110111111111101000111110111111aa1110111110110100011
1111101001111111101111111101011101111010110110011110101101111111100111110110111110110010111111111011001a11111111111110111010110111011011110aa1111111111101111111
1111111101111111111111111110111111111110110011111111110111010101111111011111111111011111011111011111111a11101111111010111111111111100101111aa1011111110111111011
1110011110111111110101110101101111010011111110111011000010111011110011011111111111101111111110111111011a00101111110100110111111011111010011aa1111111111111111011
0100111111110011110101111101101111111111111111111010111111110111111110111011111011111011110011101111100a10111110110101100111111110111110111aa1111111101111011111
1111011111101011111111111111110111111110111111111011111100011111111011011111111110010111111001110011011a11011110111011111111111111111111110aa1111111111111010101
0001111111000111011110111111111111011110111111111111110111111011111111111111111101011111111011111111111a11111100011111110111011011101111110aa1111010111111110011
1111111111101110111011101111101101111110101111110111111111111101011111010111111111110101010111111001111a01111110111111111111111111111111111aa1111100111111111101
1111111111011011111111111101010010011111000100111111111111111011001111111111110111110111111111111111011a11111101111001110011011110011111111aa1111011111101101011
1011111111101101101110111111111110110101111001011111111001110111011111111111011011011111111001111110011a11111111111011111011110110011100111aa1111001111001011111
011110111100111110110110110011111111111111101011010110111111111aaaaaaaaaaaaaaaaaaaaaaaaaaaaaaaaaaaaaaaaa11111111111111011111001111101010111aa1110011111111111101
111110101111111011101101101111111101111111111011111100110101111a111111111101111001111111101100111111111001011011111011111111001111111011111aa1101101111101110111
101111010111111111101111111111100111011011001111111111111111001a101011111011111110111011101111111010110111111011111111111111011111101111111aa1111111111111111011
111111111111111111101111111111111001011111111111110111111111011a111211121210212121221022212122022111111110111111110111111011101001101110110aa1111001111111101111
011101111011110010111111011101011111111111110110111011111101111a111111222221111222210221212011102110111111111111100101011010011111100011010aa1111001111111110101
110110111100111111110111101101011001101111010111111111111100111a011202212202220121120121122112220111111111001011011111110101111100111111111aa1111110101011011111
110111111111111100111111110101110111111011101111111011101110011a101101201122111111111010110112121111101111011111011110011011111111110100100aa1111111111101111101
011111111101111101111110110111010001010111111110111011100110111a111010211212212001212222121111212100111101010111110111111111111111101111111aa1111101111111111111
001111111101011111111001111101111111010110101100010011111110111a111121112101011220110122120121222110011010011111101111111111111110111111111aa0101111110111111010
010111010111111110111111111110001111111110111110101111110111111a111112222010100120222220111102120011111011110111101111101100011111111110110aa1111111100111111111
101100101111111110111111111111111111111111110111101111001011111a111120212101110202102001121112221011111111011111111111010111011111001111111aa0111111100111111111
111111101111101110110001011111011111011101111111110111110011011a111212111112021112122220221220121111010111011111111101110101111110111101011aa1000111111101111101
101011111011100111111111111101111111110111101101111111011110011a111122022102211112011002021121111111111111101011111111111111111110011111111aa1111111101110111111
111111010111011111111101011111110111110111111111101011101111110a111211021112222121120212022012211111011111011111110111111001111101010100110aa0011011001011011101
111100111100111011010111111111111111111111101111011110101111111a011112122221121022211211221102110111101111111111111110111111101111111111111aa0111111111111111111
111011111111111011011111110110011111110011111111111011111111101a111011102211122222211201121202222011111111111011110110110111111111111111111aa1111111101011010111
110111111111101111110101011011110111101111101111111100111111101a011012120121122212111111122220220111111111111100110111011011101111111110001aa1001101011101111110
001011101011101111111101110110001111111111101111000111110111101a011222221101221112222201110102211101110011111111111001111001011110101100110aa1011110111111111101
011111111110111101111011111111111111101111111111101111011111111a111102112222102011121112210012021101111011110111111110101111111111111111110aa0101111011001111111
001111111110001010111111011111011111111111111101111001011111111a111202111102212202210221222111122011101111001010111001011111011011111111101aa1111111110110111111
