(6,102)
(106,5)
(12,93)
(71,90)
(60,54)
(7,94)
(15,77)
(28,121)
(0,128)
(7,92)
111110110111110110011111101111111101010111111111010111111110111202211022112012222222120222022222112200a00022111012212210122112b100210221200012211110010111100111
111011110101110111111111111111101111111110111011111111111111111121212121022210022222002222222221222122b02202011112201112020212a120211112220110001111111011100111
000111111111011110111111111111011111111111111111110111101111102221212212021022210022222222220222122202b22020210111221121101021a120011122221022200011011110101111
101000011111111001101111110111011101011101111111111110011111011121212020122120022222222222122022222222b22222110112212121121112a212222220111221211001011111011110
101011111110011111011111110111111111111111001100111011110111011101112220222101222222222222220200022222a22021211102112012101101a221112211201101211111110101110111
111011010111011111011110111111001111101101111111101111001111112122021222121212202200202202211222121021b22202011010222212220122b211210002211121011101101111100110
111111111110111101111011011001111111110111111111111101011111111122012211122122222220222012222210222222a20201211111212221022110b020122220212101011110111011111011
111110001111011111111111101111110011110111111111011101111011112212120111212212220202022202222122222202b21222101010110222212212b111222020112211211101011101100111
111111111111111101101011111111110111111111111111111110111001101122220022120221222222220202220202220100b12222011111022222021101b102111201012011010111101111111101
111001110110111110100111111111111110111110110111101111110111111221220212112222112020222202222222022220b20020011111001120021112a202212201211122011111010111111111
110111101111111011111110011011101111101111110001111011110111011012101220221120222221022220222202210221b22012111111221112221211a112112122222212201110011111111111
111110111111110111111011111111111111110101100111011111011111112112221121222010222002222202220222022122a22210111102000121111112b102120012121120111111111111111000
101101111001011011011001001101111011111101010111100011110001111110101211100012202022222222022022222222a22112111100112211002210a011222222222111201111100011110111
111111111110111110111111111010111011111101111101101111111111112212102210112222002222222022220220222220b22001220020222121220202b222222202010222211000111101111101
100111111111111101101111011111101011111011100011101111101101112122222020122122222220122000202222222221b22221222111222202212222b220201222202012110111111011111110
111101111111111111111111111110111101111011110011101111010111112220122101211222120220022022000220222222b00222000100022210120121b221222120111111111111011111110011
111110110011101110111111110011011111111111110000110111111101111111221101121021222202022202222210021222b20202212121222112221102b110121020111110110111111101011001
111111110111101101000111110111010101111111110111110111110111112210212122222110021222222202222220222222b22222211122200212201001b112210212110111111111010110111110
111111111111111011111111110111111111111111111111110111111111111112011210210100222002222222220022202200b22222122011211211212001a220120221101111101011111111011111
aaaaaaaaaaaaaaaaaaaaaaaaaaaaaaaaaaaaaaaaaaa11011111111111111101002101112002022220022020222201202200122a02202222122122221212222b111111121101000110110111111111110
010111011110011111101110011101011111100110a10011110101011101111221201101122120222222222222222202222222b22200002212102122120122b020222020111111111100111111101011
001110111111111001011111111111111101110111a11111010111011111111121222102111012222221022202022222222102b12200001011212122012222b222221201111111110111011101110101
011111111110111111111111010111111111011110a11111111111101100112111102002120012222220222221221202221211a21012212110110210222201b210121212111111100111111111100101
111111111111011111011101111010111010010110a11111011110111111102120202221122120211222222120020221222121b21220211222210222100122b211111121010111111111111111110111
111111111111101111111011101111111111110111a11111110110101111110001112110122002221221212212222212201122b12202200121021221121121b122100121111111111111101111111110
011111011110101111110010111111111100111111a11111101111111110102122101111112121222202200211222101101122a21022121212220222012212b101112100111110111111111011011111
111111111101111111111111111101100111111111a11110111111011110112202221211212112020000122222010111002212a11212200012120221022122a111102222010111010011111111101101
111111111111111101011100011111101111101111a11001100011111110110020110122121102122222021020111111011111a01110212212212122220221b101022212111111111111111111111011
111111111101111101110111111011101111110111a01111111111111111111110100111121211212012020121121011111111a11101010211101110212012a222112211111111111101001101111110
011111101111011101111110111111111110011111a11111101101111111102220002120222220222122220212001111011110a01112220201212100102110a012121102111111111111010110111110
111111111111111111001111111011111111011110a10111110110110111111111011111011011100011111111111011111111a11122122022202212112221b120010001010101110111101111111111
111110111110111101111111111001111111101100a01000111011111111011111111110011101111111111111111110001111a11101112122021111211122b220012111111011111111111111111111
101111111111111110011111011011111101111111a11111111101011111010111111111101111011111111111110011111111a11022120110011202122112b202122011011111111111111111100101
110100111111101011111110111111111101111111a10000111111011100111111111111111111111111111111111101111101a01112002111021212121112b111012200010111111110011111111111
011111101111011111111111111111111111110111a11111111111111111111011101111110101111111111110101101011011a10110112022120202222112a111110121111010111111110111111111
111111111111010110111111111100011010111011a01111111100011011111110111011111111111100101100101111111111a11120012021202010121212a110211110111111111011111111101111
111110101111111111111111101110111011110111a11111111110011111111111011010111111111111011011111110111111a10122111201110011110212a011201122101111011111111111110111
011111011111111101111011010111111111111111a11111011111111101100101111111111111111111101101111111111110a01111122112212021121121b122212122111011100111101111111111
111101111011111111010111111010111111110111a11111111111010011111111111111111101101111010110111111111100a11101220221021110010122a011011011100110110011111111111111
11aaaaaaaaaaaaaaaaaaaaaaaaaaaaaaaaaaaaaaaaa11010011110101101111111111111011110101101111111111111011011a11002102201210011012212b221222121111111011111111111110110
11a110111001111111111111111111111111111101111011111011111011111101011011110111111110111110111101000111a11112001220222111020011a211011002111111111010111111101110
11a111001111010111110111111111111100111111111011101111111111111111001101111011011101111111001111010111a11122202012211122111200b121021112111111011111111011111111
10a111110101101111011111011111011111111111111101111111011011100101110110101111101111111110111101011110a10001111202111102111121a112212122110111111010011111001111
11a100111101010111010011111011101101111101011100111101010110111011000101111110110111111101101111111101a11111111101111101111011a001111111010111111110111101001000
11a111111110110111111111100110111101110111111111101011111111111011111010111111010001100111011111111111a11111110111011111100110a111101111011111111111111111101111
00a111011110111110101101101011011010011112102112002221211112221122001111111111010110111011110111111111a01000011110110111010110a101111001111111100110111101011111
11a111001011110111111110111111111101111211212200011220111101112110221101111101101101100111111101111101a11111000101111011111011a110001011111011111101111111011110
11a111111111101111011111111111101111111200201200111111222222222221000111111111110111110011101111100110a01000111110101101010111a100111001011111111100011111111111
11a111111011100001111111110110111110111121000102011102122112111210022011111111010111101111011101111011a01111111101111111001101a111111110110101101111111111110101
11a111111011101011011111111010111011001211112121010202012201210222022111011111111111111111111111100111a11111111111111111011101a111111100111010111111110101110011
10a111010111111111111111001111001111111120112220201111011122221121222101110011111001101111111111011011a10011011110111011111111a101011111011111110101111101111100
11a111111100110111111111111111111111111110212101111122201211221221001011101111101110011111111111011111a11111101111111011111010a110111111011011111111111111111111
01a010111111111111111101101111111111110212101222212211111222221210112111111001010111011111101001111001a00111101100101011111100a111110111111111111111111111111101
11a111010011111101111111011110101101111221101201021021111212112212012011011101101111011111111100111011a11100111111110111111101a111111111001011111111111101101110
11a011111011010111101101111011111111001221210210102202211111211112020111110111011011111011111100111110a11111111111011111111011a110111111001111011101111101011110
11a111101011011011111110111000101111101111202021212012222121212221211111111110101101110111110111101111a11101101111011101110111a001111010111011100111111111000111
11a111100111111111110111101111111010011221120220221212221121121202211010011011121201112110210222110211b20111110011101001110011a111101110111101111110011010111011
01a110011111111111110101111100101101111211121112111120121021201121111110011112212022212211201121222110a02101111111111111101111a011111111011111101101110011011101
10a111111111111101011101111001111101111011111221211022102100211222120011110221112111022122200112222112a21111011111111111011111a110111011111110110101101111001010
10a10111011111111111111011111111101111111112211222112211201122baabbaaaaaaaaaababbbaababbbaabababbbbaaba22111111110110001111110a111111111011111110111111100111111
11a11101111101110111110101111101110111011020011112121110212221a211120110111021110121120122121112122220212111111111011011011111a10111aaaaaaaaaaaaaaaaaaaaa1011101
10a10110111111111101111111111111111100121110212201222201110111a110012101111212212201101222022121221222101111011111111111111111a01111a0011011110111111111a0101101
11a01111111111111111111111111001111110120211202221102201111121b110210111101011121111110220212120122021211011011111001111101111a10110a1111111111111110111a1111101
11a10110111111101111111101111111111111120011022112111202212121a110212111110111100222220202112112111022021111111111111110111101a11110a1111111111001001111a1111111
11a10111111010111111111111111010100111101120220222121201110022b110102101011220002101222112101001021120112001111101111100110111a10111a0111111011111111010a0001111
11a10011111111111110111111111011011111101222111102110121221211b121122111111110210020201222102022221121122111110100111101111101a11101a1111111111111111111a1111111
01a11101011111111111111110100111111111121122021112211211100011a002211111100211212001111022212120111110012111110100111110111001a11101a1011111100101111110a0111101
10a00111110111001010111011111011101011011121211021222122111001b122122011101222221122020221112202021101121011111010101100111010a10011a1010111110111111110a1011011
11a01111001101011111110111001011111111110112212200210200010220a212112111011012221122220222221210101211210101111111111011101111a11010a1010110100111111101a1101111
11a11111111111111111111111111101111011112122201111002122202100b101010111000112212120100122112201122122222011101101111111100111a11101a1011101111111111111a1111111
01a10111111111110111111111110111111111112121101221221002112002b221211111011211022202212222201122012220122111111111101101111001a01111a1011110001101111101a1001011
11a11111101011111111111111110101111010120102222121212221101201b011222110111111211112012002222002012122222110111011111011101111a10111a1111001111111110101a1111111
11a11111111111111110111011111111111111021022210121112211110112a111112111111211002112102112011212121122201101111101101111001111a11111a0101101110111110111a1011010
01a11110011111111111011111011110111111120220210222102201222000b010222101111221001221121020112112211210220111111111101111111111a01111a1101111111111111110a1010111
11a01011111011111111101111111110111111120221212102210112122212a122211111011011011002112020211001101211001111111011111110111111a10111a1111110111110111111a0111101
11a11111110101010011101110111011111110111111111111101111111110a111111111111211101021121102012212112221212101111111111111111110a11111a1111011111111111111a0101100
00a00111111111011111100110111011110110111111011101101110111110a110100111011212212221211011221221021211211110011111111110011111a01111a1111111010010101111a0111101
10a10111111011110011111101111101111011111011100111111110110110a111101001101012022221102111120110122022212111111011010001101101a11110a1011111011111101001a1101111
11a11111111111011110111011010111111111111101111111101011111111a101011111011121122221112202111110222122211111111111111011101111a11111a1010111111111111101a1111100
11aaaaaaaaaaaaaaaaaaaaaaaaaaaaaaaaaaaaaaaaaaaaaaaaaaaaaaaaaaaaa111101111111000011222011022202022011120021111011111100101001111a11111a1111111110111111111a1111111
11111101101111111010aaaaaaaaaaaaaaaaaaaaa1111111011010110111011111110111111201210012111120122010212112101011011110111111111110a01011a0111110111111110111a1111111
01101111110110111011a1111111111011110111a0101011111010111011111111011111111112002102122010021021210121012111111111110111110000a11101a1101010111111111111a1111011
01101101111110111011a1111101111111110111a1111110101100111111110010111111111112200011002121112011222212122111111111011011111101a10100a1110111111111111100a1101011
01111111111011011111a1111110110101111011a1010011111111111111111011110111111222201100202022222222222022002111110101111111111110a11111a1100111111011111110a1111111
11111111110101011111a1111111111101011111a0111000111001011011101101111110111111111212022011202211221202220111011111111101111011a11101a1011111111111001110a1111111
11101001100111110011a1110011100111111111a1111110111111111111101101111111111002222112212221121211010011221111011110111011111011a01110a1111111110011011111a0100111
11101101011111101111a1110111110111110100a1101111111111101111111111011011111011100111011101011111110111111111110010111011111010a11111a1011111011101111011a1111111
11111101101111011111a1011110110111100111a1110111101111111111101111011111101111111110010111011111110011111111101111001111111011a11101a1110101101111111111a0010001
11101011101111111001a1111111011111111100a1011111111101111111010011111111111101111111111011011111111111111101111111011111111111a11101a1101111111111110110a1011111
11111011100111101111a1111101111100111111a1101011111111101111100111111111110110111111111111111111111110110111111110110011111101a11101a1101111100110011111a0111111
11111111111111111111a0111110111001001011a0111111011111111111110110100111111101101111111110110111101111111111110011100111101011a11111a1111111110111110111a1101111
01101111101001111111a1111110110010001111a1011101101110111011111110111111001111110010101111111110101101111010011111011110111111a11101a1111011110111011101a1100110
00111111110111110101a1001111011111111111a1101111111111111111111111111111111111111111111111111110111111111101111111011010111111a11111a1111011111111101110a1101100
10110101100110111111a1111111111011110111a1111110110111111011011111100111111111111111111111110101111011111111111101110111011111a11010a1101110111111111111a0011111
11111011101010111001a1111001111101110110a1110010111110110111011111110011101001111111011111011111110111111111011110101011111000a11101a1110110111111111110a1011111
10111001101111111110a1111111111111110111a1011011111111111111111111011100111111100111011011111111111010111111111111111111111111a11111a1111111010111111101a1111110
11011111111111110011a1111001100111111101a1111111111111111110111101011100111101111101101111111001111101111111011111011110111111a01111a1111111011010011111a1111111
01100011101111111111a1011011110111010111a0000111110111101011101101101010011010011110100111111011011101111111111101110110111101a11110a1111010111101111110a1011101
11111111110111111111a1111111111111100111a1111101101110110101111111110111111101111101011111111101110111101011101111111111111111a11111a1101111011101110111a1111111
a1111111111111111111a1111111010111111101a0101101110111111101111101111111111111101111111111111111011101001100111111111111110111a11111a1110111100111111010a1110110
aaaaaaaaaaaaaaaaaaaaa1111111001110011011a1111111011101100111111011101111111111111110100101011111110000111111111110011110001001a11110a1111110111101110110a1111111
0111011011111110010011111111101001111110a1111111111101111111111100001111111111111101111110111101101110111110111101010111111111a11101a1111111011111101111a1111010
0110111110111111111101111111101110011111a0100111111011111111110111111111011011110111111111011101111111101011010001111111011110a00101a1111111111110110110a1101111
1111011110011110111011110111101111111101a1011101011111111111111101101111111111101011110111111111110011111110111100111111011111a11011a1111111111111101011a1110101
1111110011110111100111111111011111101111a1111111111111011111101111111111010111011111001101111010111111111101111100110011111111a11111a1111101111111111101a1110111
1111111111111110111010100111111110111111a1111111111111111111111011111111111111100110111111111111011101111111111111111100101111a11111a0111011111111111011a1011110
1000111101111101101111011110111111111111a1011110111111111110111111111011111111111101111110111111110111111101111110101111011001a11010a1111011111011101110a1111010
1111111011111011110101011011110111010111a0111111111111111011011100111101110011111010110111111111101111101111011110101111111111a11111a1111111011010011111a0111111
1111111110101111010111111111111111101110a1101111111111111111101111110110111101001111111110011011111011111111110110111011111010a10111a1111111011111011011a1111101
1110111111010101101111111010111101100111a1111111111111111010111110111111111011111111110111111111110101011101111101111111111011a00111a1111111100111111111a1111111
1110011111111110111111110111111010111111a1111111111111101111110111111111101110111101110111111101001111110111111111101101111111a01111a1111111011011101100a0011110
0111001101011101111011011001011111001111a0101101111111100111111111111111001111111001101110100011111111111110111111001101001110a10101a1101111001111111110a0111111
1111110100111011111101111111111101101111a1111111001110101111011111110111111110111011111011110111111101111110111110001010111111a11110a0111101100111011111a1111110
1111100101111101111101001111001111101011a1111111111110100111111111111011101111100110100011110111111111111111101101100110111101a11101a1111111111011111111a0111111
1111111011111111111111101110011111111011a0111101101111111111100100111110110111111110101111111011111110111111111111011111111110a11101a1100011111111110110a1101111
1111111001111111110110111111101111111111a0110111011111101111100101001111111111111110111110111110111111011111110111101101011111a11111a1111100001111111011a1100111
1110111101111011111111011110110111101011a0111011101111101011111110111010111111111011101101111111101110000010111111111111111111a10110a1111111101111111111a1100101
0101111010111110111111001111111111111010a1011100111111111101011111101111111111111110111111110111111111011111111110011110111101a11111a1111110110111011101a1111101
0111111011111111111011111101101101111111a1010111011111111011011111111110111111101011110101111111110111111010011111111011111110a01111a1111111110101101111a1110111
1001101111111111111111011111111111111110a1111111111001110010011111011111111111101110111111011110111111110011111111111101011010a11111a1111110110011111011a1110001
