(29,143)
(105,24)
(104,92)
(109,3)
(41,38)
(20,142)
(27,71)
(62,11)
(92,107)
(11,74)
111101111101110111a11010111010010101111111111110111111111112010212200022121102a011222111001110110111111101001111101111111101101111111110111111101100111110111110
111111010111011111a11111111111111110101111111011111111110112201212122022110101a220222212211101110111101111111111011011100111111111101011100101000111111111111110
111111111011110011a01110110110001111111101111111111111110112012220212112121112b112120121011111011111011011111111111111111111111111110111111111111101001111111111
111111111011111111a11101111110111111110111111011001111101110212122211010211210b121110011011010101110011111101111011111111011111111110101111111111101111111111001
110010101111011011a11110110101111110111001110111101111111112220121212222020120b212011120101110111010111111111111101100111111011111111111011111111011111111111111
111111111011011011a10111111111101011110111110111111111110100221011220111110010a210021010111111111110111101111011101101111111011221212222121001202112111212001001
111101111110111111a11111111111110110111111011111111011111101221012110122211111b211121011011111111111111111111111111111110110011021121112222111112200202112202111
101111111011111111a10111111111011111111111111111110111111100122222122122010210a112112221111111011011110001011011111101111111111112222102211222111221212212122111
110101011100111110a11100101111111101110101111111101110111112101222200020011011b202222022210110011010100011111111111011111110101111112011201212110102112212210111
111110111111111110a10111101111111111111101111101111111011112210212210222212211b221002221101101010111110101100110111111111101011020122110210001122222212211210101
010101110111111111a01111011011111110011011111111111111111110201212022020121221a210112212211111001111111111111111111111111111001202010020210200101201100101112111
010101111111000100a11111011110111111011111111111111111110001122011112112210121a020211002101111111110111111011111111011101111111211011221010012021221021212022011
111011111001011111a11110110101111111111110111101111111111112012222220021222222b222200210211111110110101111001011110111111010111120201202010221221111121211202101
110101110111011011a11011111111111001001110110111111111112222222222222022112222b202222202201111011111101101111011011111011111111022201011111121202222212121011011
111111111100111111a11111111111111111111111110110101110111112122021022202022221b112122111111111101101001111111101111011011111111221201112211121022221002022120111
011001111111110101a01110110111011111110101111111111101111222222222201220102222b022222021211110111111111011111111011010111110101202210220122021212222112201112111
011011101010100100a11111111111111110010111101111111110112211220112212110020222b022202212211111111100101101111111111011110111110101121112220002010111221012010111
001011011111110011a10111111110110110111101111110111010012021101221202201222122b100012021111111111111111111111110110011101111110021102211112121221101212201212111
100001111111111111a11110111111101111010110111001111010100021222222222020202220b122022221111111111111111011110101011110111101111021222112222222221211222101101111
111011111110101111a11111111111111010111011101011110011112022012220221222200022a210222222211111111111111111011111111111110010111221021201021010212201221212212110
111101111011010110a11101001111111111111111100101111110002112220220202110222222b220122001210111010101101111111111111101111000101212112111011222122212120111222111
010111111111011011a11111111011011111111111111101110011110112222220222222210200b201202011211111111110101111111111111111111111111112011122121201112111020222111110
111100011011110111a11110010111110101111111111011110100111002222022212022222222a211002201211111111010111111111111111111111011011020111111200121021010122122021101
111111110111111111a11111111001100111111111111110111011111111221221022201020221a122222212110110111111111011111111111111101111100002111222120100212102121221212111
101111001110111111a11111011111111111111111111111111111110212111022222021022020a012212221101111111111aaaaaaaaaaaaaaaaaaaaaaaaaaabbbbaaaaaaabbaababababbaabbbaaaaa
101011011111011111a01101001111111111111110101011101101011222222210222000222122b222200212101111100111a11111111101111111111111111121211211110202111101210012010111
111111111111001011a11111222022200221111122122211102111111020100211212210101110b101111211011111111111a00101011111111101111101111112012121012102020110020221222011
100011111011111111a00112221211221121212011012112121211111011222221121202221102b202122010101111111111a01111111110111110111111111212210022120211122121010122120111
011111110101011101a10111222121212222110120122100222121112212220122210221111112b110011101011011111110a10111111111111111111010101220222221010221101021112121200111
111111111111111111a11111202121111012022121112021021121112201222212200111212121a202211211111101111111a11011110111111111110001110220011211121222110201021212101111
111111001111111111a11112111020221211120201211222122211112110112221001220022021b121121211011101011001a10011010011011111101111101222012121020112221202011110221111
011110111101110111a00002102112202221101112221002211221010210212121221111211222b102220201001110111110a11111111101110111101101101212121101221201221211202011122110
111111011110111011a11102110121101221200112121020222010101212121212112122202111a111112101011111111111a11101111111111111111111111122112121022211201112111220212011
111111111101110110a01112012011211101112122121202021020101200222012101020110100a111121111111111001111a01111111101111111010101101212001121001022222221121211222001
110111111111110101a01110220201111121120210120211210101011122201012212212212212b110010111010111111111a11111011001111111101111111021000211211121221212121021211101
111111101111110010a01111221120020201110102222202222221111112122222111211121121a121022211111111111010a01111111111111101111101011111111101011110111111111101111101
001111111111111011a11112211212021002022221101021200210111002022012111000110020a220012111001111111011a11101111011010010111101100101111110111110100111110111010100
101110110011111111a11110212122120220111101221101011211111110202112202022001000a221210201111101011111a01100111111111110111100111110111101100011011001010111111111
111101110111111101a11111122122222220011112010110122221110111112111122201212110b111112111111111101111a11111111110110111111111111111111111011111110111111111011101
111110111100100011aaaaaaabbbaaabbaaaabbbabbaabbaaaaaaaaabbbabbbbbbababbbababbab100102110111111111110a10101001011100110011111111110110111011111110111111111101010
1101010110111111110111112202121112102102222221212020101122111122212101201220110111221201111011111111a10011111111111011110101101111101100111101110111001111111111
0111111111111111111111110110111211012121212011022111201012211012210212211222001120111111110100111101a11111110101011111110111100111111101101011100111001011001011
1111011001010110111110110022111122221221011121121211210000111111111111101111011011111101011011101111a11111011111111110000001101111101111011110111111010111111111
1110110111111111111111122110222221111220011022212202211010111100111111101111001111111111111000011011a11101111110110110111111111111111011111110010111111110011111
1111111111111111101101112111222221111011001120121122110111101111111101001101111111111111111111111010aaaaaaaaaaaaaaaaaaaaaaaaaaaaaaaaaaaaaaaaaaaaaaaaaaaaaaaaaaaa
1101001111111001101111102222020122122002221010012010201111111111111111111111111010001111111011111101111111111111111111111111111111111101111111111111111011101101
0111011111110111111001120021221111101221222220201122211011110011110111011111111110111110111111111111110111111110111111111000111010101111111111111111111111111011
1201111211122221222211022220022221220002220022010112211111110110011111111111111110111111101111111111011111111011111111111111111111111011111111001111010111111111
1121112022022122211221220221010220011112010222220201210111111110111011111111111101111010111111100111011111110011111111111111001110011011111011111111111011011011
1202220122222012111120222202211112111011212200112020010111100101111111111011111110111110110101111110110011011111111011111111111010111111000111111110111101101111
1101112110211121111022112101211010120022102011022120111001110111111111111101111111110111110111010111111010111111111110011011100110110011111111111101111110111111
1120212212001211101201122222021111121002212221112222011110111111110100111111111111111111111111011111111111101111011111111111110111100111111111111100111001111101
2001121202221122102121122221120101202110210112222221211111100110111111111010001111111111111111011111101011101110011111111111111110110101111111101111111101110111
1111122222022222100122002121212222100211221111212101011111101111111111111101100101110111101111111111011110111110111111111111011110110101111011111111111111111110
0101212122222122110112120200211121222012221212221011110111111110111101111111111aaaaaaaaaaaaaaaaaaaaa110101100010011101010010100111011011111011111111111111110101
2210110222211201210110122221111010211012110221022202110111100011111111010011111a1111111110101110111a111111111001111111111111111111101111111011111111111110111111
1102222121122221111222212110111111101011011101111111001111111111111111111111011a1111101111111011101a111110110001110110011011111101111110101110111111011011111111
2011110202120202111122111211111111111111110111111111111101110111111101110111111a1110111011011110111a111111010011111111011111111111111110111111111001011101111111
1211212011110221210222111011101111111111111110001010111111111111110111101111111a1111011111111101111a100111110010011110111110100111011110111110011111010111100101
2102101121102112021122210101010011111110011111111111111111111111001011101001111a1001011110011111111a110011001111100001110110100101111111011111010011111111111110
2001000221212212220021111100111111111011111101110111110011101101111110111111011a1111111110010111111a110110011110111110001111110011111011010111101110111110011101
1001212202222010211212002011110111111101011111111111111111111111101111101111111a1111111111111111101a111110111001000111111110101101111011110011111101111111110011
0211211121021122020101222211111011011111111111111110111011101111110111001110111a1110100110011111111a011110111101110110111100111111011110111111100110101110111001
1110211010120112021101122111111101111110110111111111111111110111011101111011101a1111111111011111111a011111101111101011111011101101011101011011011111100111111010
2221221212122221212221022011110001111111111011111111011101111111101111100111111a1010111111111111111a101110111111110111100111101111110111101101111101110111101101
2121101122212210222010121211010110101101110001101101011101011111111111111111101a1111110011100011101a011001111111101111011101101011111111111101100101111111101101
2121122002010112021202100211101111001111111011011011111111111111101011111111001a1111111111010011111a111111111111101111111101011001111111111111111001111011101011
1012102211201212211012201011110110101111111111111011110111111101111111111111111a1111111111111111011a111100011111111111110111111111011111111100001111001011111101
2222210222121221120102021111111111101111011011111111111101100111011111011111011a1111111011100010111a111111111111111101111110111111011101110111101100011101111011
2021211212021200222121020111111010110111001101111111110111111111110010110111111a1111111111011111111a111101111010101111111111111110110101110111111111101010011011
1220122101211221101111121111110111111110111010011111110100100111111111111001011a1110010011111110111a101111111111010111111111111111111110111011111010101011101111
2012212201212200111102221211011111101101111011011111011111110011110111111111111a1110101011111011101a101111101111111111010101011111011111010101111111111111011101
2221101222222010110020212200101111101111111111111011111111100011111111111111111a1111111011111111011a011111111001111110011111101111111100111111111111110100101110
0111222222121112012212111111111101111011110111001110101111100111111110111100111a1000111101101001110a01111110110111101011011110101111101111101101101011101111111a
bbbababbbabbbbbaaabaabababaaaaaaaaaaaaaaaaaaaaaaaaaaaaaaaaaaaaaaaaaaaaaaaaaaaaaa1111110011111111111aaaaaaaaaaaaaaaaaaaaaaaaaaaaaaaaaaaaaaaaaaaaaaaaaaaaaaaaaaaaa
2101211021121100210111100101111111101011111110101111101111111011111101111111011111111111110111010111011111010111101111111101110110111111111100110111011010111011
1111111111011211111120200111111101110111111111011101111111110111110111111111010000111110101011101011111110111111111110111111111101101011111111111111111101111111
1011110110000111111111001110111111111111111111010111111111111110010111101111111111011110001121210122122200112201121012121211000111111110111111111111111101110101
1111100101111011111101111111111111110111111101111111110101111101111111111010001011111111010112220111011122122022122112012211111011110111111110111100011101011111
1110010111111111011011101111111101101111111111110111110111110111110101111100100101111111110012220011120201122112110122122101111111100101111011111111111010111111
1101110100111111111111111111111111111111111001011111111011111011111111111110111001111101111101221221112102212222121211221211010011111111111011111101011010110111
1010000011111101110111011111111011110111110110111111101111001101111111111011010110111111101112102221200120120111110101201211111100111101111111111011011111000110
1011111111111111111011111111110011101111011011110111110111111011111111111011111110111111110010222111102222212212221102001200111111010101101111111101111111011111
0010101110111111101011011111111111011101101101111011111100111111111111111101111111011111111122011120222201110221202102211011111101111111110010111111110001111011
1111110111101110100111110101111100111111101111111111000101110101111111101110101111110111110111212121112210112220212011111111111110011111111111111111101111101110
1111101101111011111111111111111110111111110011111111111111111111111111011111111111111110110010121012021122220211201121010100111111111011101110100111111011101111
0111111111011011111011111110111101111011111011111111111111110111011010111111111111111111111012211022220020120020202201221201101010110101110111111110111111011111
1111010111110111111011111110011111111101111110111011011111111100110111011111101100111111111111210220111121121000121102212101010101111111111111101101111111111111
0110111100101111111101111111111010111011111101111111110111111110111111110111111111111110111122220201212120101020012101120101110011100101111111011111111111111111
0110101111110111110111111011111111111111111111111110111111101111101010111100001212110222222220202111201212112022121212222211101111001111101111111111111111011111
1110011111011111001111111111111111101111011110010111111111110111011110111111122212111110221012022120111220021212221120200211111111110101111111111001111100101111
1111111111111101111111011101110000101111101111101101110010101110011110111111111122012121212222021221222022201001211121212211110111101011111011011101111101111010
0111111111111111111111011111111110111111010010111011110110111111111001111011112020112012112100012122221220211212102220021110111001111011101110111010101110111111
aaaaaaaaaaaaaaaaaaaaaaaaaaaaaaaaaaaaaaaaaaaaaaaaaaaaaaaaaaaaaaaaaaaaaaaaaaaaaaababbaaabaababbabbaaabbabbbbbababababbaabbbbaaaaaaaaaaaaaaaaaaaaaaaaaaaaaaaaaaaaaa
2011222222112120001110110111110111111111111111111111101111110101111101101111111220021222202022221002202122012212221121212211100111011110111110101111111111101111
2221022011121121121110111110011111111101011011011111111111110111111111001111002010122011112122212200012112202022012121020011111011111111110111111011111101111111
1012112222112111220010111110011111111111111111011111111111111111111111101111122201102122112222222110121202212212101110201211010010111011111111101111111111110111
2221011220212221220000011111100111110111111111011111111110111011110110111111112122201112022020222201110120222111102112221211000111110001111110000111111101010111
2112212222121221211111111110011101110111110111101101111011011011111110110001121000101121222022212102220222221020221120210211111111101101011101101111111111111101
2112202221221011121111111001111011011111110011111110111111110111111111101110110111212122222122202222212101221220120212221210110110101111111110000111101011110111
2122202012111200001111111011011111111111011110101001011111111111110111110011001122021211221220222122122202121120221211101011011111101010111111011110100010111111
1200111111220211221101111111110101110011101111111111101111011111010111111111111110211112221112101220212121221112021002221101111110111111111111101111111111111111
2121011121011220011010111111101111111101111111111111111111011101101100111110100221111110221122011212220002111111102211012011111111001111111111110111011101111110
2220221121211012121011111110101111111111111111111111111111111010110111011011122211122212121220222212000021212221222201212011111111110100111001111110011011111111
0112211112221212220110111011101111111101100111111011100111011011100011111111112122021211221020212220222200220211202212211210011001111111101101101101111111110101
2122121021210221211011101101101111111111111111111111101011110110010111110100111220120211200212220120222222210120221200021111111111110100111011111111111011111111
1111022212101221221011111011111111111111110101111011111111011111111111111110122022201122222112022102222102202011020221110111101111111111111111101100110111110111
1212111221112112201111111111101111101111111111111111100111001111111011010111101122212212021012022122112122011111110011111111110111001101011111011101010011111111
2220122112122120121111111111101100010011111111111101111110111011101111101101110101011212001012221121002211111111011111110000110100111111111111101111011110011111
1112220221021122021011111111011111101101111111101111010101011111111100001011011221122212002121100100221211201111111110111110110011111111000111111111011111110110
1110001222211110221111111111111111111011011111111111111110011101010111111010122121211111112212122221011122111101001111111110111100111111111111011011011111101111
2022121122202220121101110111001110111111011111111111100011111110111111111100100220001100120221121110010010200111111011101011111111101101011101100111011011110111
1021122010222112221110110111111110101111001111111100101111111011011111110111111222212222210220011020112101201011111111110101111111100111111111111111101111111111
1212122020210101121010111111111111001101111011110111111110101111111111101001100222021222112002221210012012211111111101111111111011111111111111011111010111110111
1101011001222001021101111010011010111101111111011101111111101111101101011011110220102212122222100122211222211111111101111111111110001000111111111110101110111111
1112121121201102101101101111111111111110111111011101111110111110010111111010111100221212201022220211111221211111111111011111100100011110111011111111110110011111
1211111111122121221110111011110111101111110111111111111111101111111111101111112112221210022100120221011001111111010011111111011111111111101111111011111011010111
1222221102100111011111101111111111110110101111010110011111111111111111111101112121220101011222211010202022111111111101100111101111101111111111111111100110000111
2010010201220022201111111111111111111111110101110111111110111111110110011101121102210211110201111221121012210100111111111010111000011111101111111110011110111100
1221202101112200211010111101111110111110111111111111111110011111011111101111111111111011111110110111011111111011111111011111110111111111111011111111111111111011
