(7,144)
(112,58)
(3,36)
(78,17)
(42,45)
(31,70)
(14,126)
(5,83)
(51,24)
(58,47)
11111111111010001a111002002112012211102221121100202111011a110111111112112120112100002221212201121111111111011a112122221222222110211202021212111100111a1101111110
01111111110111111a011222120211012211121121101121001111101a111111111011101222112110112021221102210111001111111a121121101222102201222221210211111111111a1110111111
11001111100110001a101211120222121222120112122111112111111a111110010122211012002112210220211010111211111101111a121110211120222022221002201021111111111a1111111111
11001110101111111a001121121022012012222021121222222111111a101010111121020100212122020111120212001211111111110a102120210112222202122222222221201111010a1111111111
11110101010111111a101121112112122211222222112112112111110a110111111122121212222112122011220112210201111111010a101202122012212111012110110022111100111a0110011110
01111011110111110a111011112222112110010122111002121011011a111111010021211012102022201012221211011211111100011a121210122221001121021221112211201011111a1111111111
11011111111010011a111021222111202220122212210201210101111a111111111122010211212101211221201202212011011011000a100002122201022011212022212111100101011a0111111111
00111111101110111a101122021100021120212222022111111111101a111101111021210122112211121110220112122111110111111a112121221222011002011121021200211111100a1111110111
11111101011111101a110121111222011200212211210200202011111a110111110111210220112111211002212102121110111011111a112120111111111212201200111222011111111a1111111111
11111111111111111a110112002012122021112120212101111111111a111001101121022121102212120021222121212111111111111a100121020201111222002220120201010101011a1111010111
00111111111011101a011120102202210110122012221020122111111a110111101111010212201222102022021102211201110111010a100212220011122222021020020112211111111a1011110010
10111111111111101a111112000101122220110222111101121111111a101111111002022121012212212120112012211211111111111a121001202012111101122211112221011110101a1101111011
10111101110111111a101111001120220102111221102102112111111a111110111111022100201220222122002121221111101011111a012121101222121111110221210121111111111a1010000011
10101110011111111a111002201102022122111222020111221110111a101111010121020022110220110211122111001111101111111a121221112012101122100111210102211111101a0111111101
11111111110111111a110222122101002022202100122221100110101a111010101111221012120012210122222111111210111111011a122221101210201002222000111120211011111a1111111101
11111111010101110a111111110121122201111222112201201111111a100111111122011112110120211212101200210011111101110a022021022112202121202111101111201110111a1110011111
11000111011111111a111112122011211111112122111210220111022a221012202122222020222022201001112122222111111111111a112011112022210122212211212111111101111a1111101111
11001111110111100a111121122122012212100112220111212111102a012212020211002202202212121212001112222001110111100a112212021120212202201221212121211111111a1111110011
11111111111111011a101111111111111011111111010111111101111a210111100121102222022012200212121201110110111111010a122121110211221122211221212210211101101a0101010111
11111111111101111a111101110011111001111110011011111101020a001111110202212220212222222111100101210211111111111a102220202111022101101111111211210101110a1111101111
11111101111111101a111101010101111101111111101101111111002a111abababbaaabaaaaabbbaa211111111110111110011010101a111021212102212210210122021212111111101a1111111111
10110011111111111a110111101110111111111111111111111101122a121a0121211112202120112b220110111111111011111101111a121212212210221222112221020101101111011a1111111110
11101101110101111a111111111101111111101101111011000111121a122a1210120112022112210a001110111111110011011110111a102211211111200201121101202121211101101a1111111101
10111011110111011a101111111110101111011110111111111011121a121b1112220221202002211a021111111111111110111111111a101102012212111212122101220222111111110a1111100111
11011111111111110a111011111111011011111011111100101100121b022b0220221112212212101a200011101111000111111111011a112222002212112112120121211020111110001a1011111101
11100011111111111a110010110101111011101111010101111101102a222a1111210021021101112a112111111101100011011111111a000211122112222222210021112210211001111a1111110110
00100011111111111a111101111110010010010111011111011110020a122b1221122122112221201b121011111111111111111111011a110200111122110220122111112222111111111a1111011110
11101111110111101a110111111111022020220112211212001112222a201b2222121220202101121b102111111111110111111111011a122221101221110020102210222002211111011a1111111011
11101111111011111a001110110111022112001211212221021110202b221a1122121121222120121a221111001011111111001111101a122010211012111122012112112200111111111a1001111111
11011111111111111a111111111111012102021001211101012121122b212b2202211200221122121a222110111011111011011110111a001101001110111100011111011111101111111a1111111101
01110100011011111a110111011111220111122121110221001110222b102a2112101201222210110a220100111111111110001111111a110001101011111111011010111111111111111a1111001111
10111011011101111a111111111111211010111000112022222120222b220a0112211211222212110b211111000111111110101101111a111111111011111111011111111111111110011a0101111101
10111110111011111a101111110101122112122212022212221221121b211b1212110120210122221a221011110111101111101011111a100110111111011111101001101101111011111a1110111111
11101001010111101a101111100111002221211001112112221122220b200a2211201200022220221b212011111111111111011110111a111011111111101111111111111111110110111a1111111110
00101110101111111a011111101110122222221022202212221222121b222b1200111221011111012a102111101111111011111101001a011010111111111111110101111011111111101a1111101011
11011111001101111a111011111111021120111100111111112212011b112b1111122212120212111a112111111011111011111010010a111111110111101111111001111111111110011a1101101111
11101111112221211a121012022021212102200122221200120220002b201b2110111112002211221b012111111101111111111111111a111111101011110011111101111101111111111a0111110111
10111111122122220b211202211012222122220111201112220220022a202b0122110120121211121a212111110110001111111111101a110111011110111110110111111111101111101a1100111011
10110111010212201a222120020122011222021211222112221002212b221a1022210122111221012b110111111111111111111010110a111111111111110101101110011111110111111a1111111111
11111111002111221baaaababaaaabbbabbbabbbabaaabbaaaaabaaaab210b1121102012202122210a010111110100101111111011111aaaaaaaaaaaaaaaaaaaaa1101111111111111111a1111011111
1110111100212001002210002001211220010121101000011121120022002a1012220122222010021a20211111111111110111010111100111011001101101110a0111111111110111111a1111111111
1110111110122211020211212122112122222011222222101122220012220b2012111221221112221a11110100111011100110111100111111011111110111100a1111111101110111101a0111110111
1110011112112222012211121222122220220002020211212200011101222a0110121111202022111a11211111110001111111001011001111111110111111111a1011110111101111011a0110011111
1111101111000111112121122211101020202201102021002022222022022b2122212102122212110a10010110110111111101110110111111010111111111111a1111011101100011011a1110101011
0111111112100122112020022122110222120220202201111122102222020b1012012020200210201a12001001101111110111111101011111111011111101111a1011111111011111111a1111111111
1111111110211101222002221100021222002212222222120222222222222b2211120100211212112b12211111111111111101011111110111111111110011101a1111101111110111111a1110111101
0101111110201001221010212210212020220220222000022021122022220b1011111011111111101a01000111111011111111111111101111111111110111111a1111111101111111111a1101111101
1011111112211111222222120122101112002220222221222210200020020b1101111111111111111a00011011110111000110110111101111010110111011011a0110100111111111110a1111101111
1110111100022200112021212021212222200221112222212122001220221b1111010111110101111a11111001011011111111111110111111111111001011101a1111011111011101111a1111010110
1111111101200122111220002011101022222222222221212022220220221a1011111111111111011a11101111011111010111101111011111011101110111111a1011111001111011111a1101111010
1011110111121212212120101111022222020222212220221202012222022a1111111111111111110a10010011110101111111110111010111110111111101110a1111110111111110111a1111011111
1111011101112111022222221111112222212222022222102200220212221b1111111110110101110a11110111111101111111100110111011101011111110111a1111101111111111101a1101111011
1101111112220221220122112201022221202022202212112022102202211b0111111111011111111a10110001110011111001111001011110101110111111011a1111110011111110111a0111111011
1111101112211101120212222120201220122120211011210022122122201b1110101111011111110a11111110010111101101011111111111110111011111111a1011111011111111111a1111111110
0110101110222222022111211221202212222221022222222120222220111a1100111011011101111a11111100111111111111111111111111111111001111111a1111111111011111111a1111110111
0111111111100110122210121122210022012200222222021112012222021a1010111111111111011a10101101111111110111011001111111011111101111110a1000111001100110101a1101111111
1011101112112200102222210222202221222120202110221202222110002b1011101110011111111a10111011111111111111111010110011100111110111001a1111100111001111001a1101001110
1111110111012221121112222020120220202211211000210222110110011a0101110111111111111a11111111101111111111111111111111010001111110111a1111011111001110111a1100111111
1111110102212110121011222111021022222221211211211121002212202a1111111111111011111a11111100111111011110110111111110111011101111111a1111111101111001011a1011111101
1111101000000202222212100212221022211212102211112111211012120a1010111111111101111a11111110111111111111110111101111111010011101111aaaaaaaaaaaaaaaaaaaaa1111011111
1110111111221200001222122221101220120121222112211021222201200a1101011110111110110a110111101111110101111011111111111011101011111110110111111110111011111111111111
1011111112111110111201221220022222220222211222111121012112020a1111010101111111111a111111111011110001100110111011101101111001101110111111111101001110111111111101
0111111110221220221122020102201122200222222021221110102220110b0111101111101111010a110110111111011001101111111101111100101110111010010111010111110111111111111111
1011022121220220002222120211112101202120122221221100110112222a1111011111011111111a001111011111111111111110111101100111111011000111001101111101111111111011110011
1112111222220220200212202122202222220211211002222012112211212b1111111001110111101a111011111111000110001111111111001111000111111111110111111111111111111111111011
1111122102222201212021120212121212212110122010210221212122122a0011101001101011111a111011111111011011011111111101111010111110011111111111111010111110101111100111
0121221111222221012011222120211121112012110202122221212020022b1111101011110111110a111111101111111010011111011001111011111011111011111101111101111111111111111111
1120000112202112202012212210002112101021222102012121212110212b1111111110001111111a111101111111111111111110111111101101011111110101111110110101111110111110100110
1121112111101122102211111121121212212111010202122021100120122a1111010110111111111a101101101111111011111110111111011111111111111011011111111011011011100111100101
0111202010222021021220011010010221212121111021120112122101121a1111110001011111111a111011110110111101111101111001111111101101111111111111110011010111111111011111
1111112122011112120101200111002211021122111221221120222221110a1111111111111111111a100111111111111111111111111111111101111111111101100111101111011101111111000111
1112022212111201111112021111112112202111002122221122101212112b1111111111100111110a011111011111111111101101101101111011001111110111011111111111111111101101010111
1112201122210112221222120121222112211101012111122111211211221b0011111101111011111a111111111111111101111111111111111011011111111101110111111101111011111011011111
0011110122212220201201022120111211111001110010111111111111011a1101111111111111111a111101011111110110101111101111011101111011110111110111111111101110111011111011
0110121210221202211112021211022111111000010111111111111001111a1100111011100011100a111110111100111111110011111111111111111011110111101001111110011101011011111111
1021022210212212101001201112011101111011110011011011111011011a1011001010111111111a111111111111101111101001101011101111101111111111011111111011111111101111111101
1102222210112012222220102221111211111111011111111111110111001a0111111111101011101a111111110101111110111111101111101111111111011111111111011111110110111111100111
0120012102202011212202200021102210111111111110001111111001111a0101111111111111110a111110111111111001101010111101101000111011111111100111111000111101100111111011
1122112111012122021211202102210211111111111101101110111111001a1111011111100111111a111111010111111111101100111111110111101111111101111101111110111001111110101111
1012102111101122210212011221221110111101111110101101111111111a1011111010111111110a100111111111101111100110111111110111111011001100111111110111101111101111110111
1112001201011222001011121011110110101010010111110111111011011a1011111101110100111a111111110001001111111110111101110010111111110110111110011111111111111101111111
1111111110211000120202102022212211111110110011111111111110111a0111011111111110111a110111111101101111111110111011111111001100111110010011111111111111111111111111
1020202222211001101210211211102211101100011111011110011011111a1111111101110111110a101110101101111110aaaaaaaaaaaaaaaaaaaaaaaaaaaaaaaaaaaaaaaaaaaaaaaaaaaaaaaaaaaa
1121211112211222202201022011221111111111111111110111111111111a1111001111111111110a110011110101111111a11110001101111110110111111001011101110111111111111110111100
0120122120021100000201221221121201111111111011111111111101111a1101110001111010100a111111111101110011a11001101111010111111101111110111111011101111110110111011111
1012122201111111111120211111102201101111111011011101111111110a1011011011110111011a111100111010101100a11111101111111111101110110111111111001111111110111111110110
1102021102212002211122211012122211111110111101011111000101110a1101101111111101111a111111111010110111a01101111101111110111110111111011111111101110111110100011111
1111120202112120120101111011212110111111111111111101111111011a1110011101111110011a111011111111111010a11111110111101011111110111111101101111111101101101111111100
1121211211021212211022011212120201100111001111111101111110001a1111111100111111111a110111110111111010a01111111111011111111111111111101111111111111101111110111011
1120111211111100111112101112221111110101111111110111111110111a0101111010110110011a011110111101111111a11111110111111110110111111001111111111011111110111011011111
1122020111211112211211022112021111111111011111110111011101100a1111111110111101111a101111111111101111a10100111111111110010111111111111111010110111111111110100111
1011122111222112112010121221101011110101111110011111100111010a0111011111111111111a110001101111010111a11101011111101111111011111111111111100011011000011001011111
1111201122111022212122211210110011111011111111100111111001011a0011111010111101110a101111011111111111a11011101110111011011101111011100111101111110111011110111111
1111110111111111111010111111110100111111101110011101111110101a1011111111101111111a111111110110110101a11001111011111101100111111111111101110111111100110111111111
1110111110011111101110111111110111111111011111111110101010100a1111011101111011111a101011011111111110a01101111111011011111110110111111111111111001111001111111111
1101001111111110101101011101111111111011110111100111011110011a1101111111011111111a111111110110111101a11110111110111011100111010111001110110111111111100111111100
1111111001101001111011100111111111101111011100111111111111111a1101101111110111111a111111110101011111a11111111110111110001111111011111111111101101101100111111110
1111111011011101110111111011111111111111111111100111111111110a1111111101111111111a111101101111110111a11111111101111111110111111111111011111111101011111111110011
1101101111101110011111111111111111111111111111111111001111111a1111111111011111111a111111101111110011a11101111111111110101010111111111101111100011010111111101111
1001101111111011110111011001011011110111001111111111111011111a1111111111111111111a111111101111111011a11111111111111011111101101011111110110111111111011111111001
1011011100101111111011111111011110111111111111011111011111111a1111110110111101111a110111111011101101a11001111101111111010001111100001111011110001111111111110101
1010111110011001101111101011110111111111111111111111101111011a1111111111011011110a111101011011111011a11110111000011101110111111100100111011111111110011001110111
1001111111101011111101111111101111111101101111111111101111111a0111011011111111111a101111111110110111aaaaaaaaaaaaaaaaaaaaaaaaaaaaaaaaaaaaaaaaa0001001011111111110
1110111111111111110111001100101010001111101111111011111111111a1101111111111101011a1011100101111111110100111111111111011111101111111111100111a1111011111111111111
1111111001111101110110111111110100111101111010111101100111111a1111101011011111011a1111111111110111101111011110110111111111111111011001101110a1111111111111010101
0110111111101111111010111110111101101111101111111111111110111a1111101111111111011a0111111111111011111110111111111111111101111111111011001111a1111111111111111110
1101110110111111111111111110111111111111110111111111111111111a1111111101011111111a1110110101101111111111111111101111110111111111101111111111a1111101111101111110
1111111100111101011111111111011011011111111101111111101111110a1101101110011100111a0011111111111110111111111101101111011111011111011111111011a0111101101101111111
1011101110110011111111111011111101111111111011011011110111111a0110011111111111101a0101111111111111011011010111111111011111111111100111101111a1011110011101110111
1011100111110111111111100110111111111111011110111111111111001a1111101011111111111a1111111111101111111111011111010111111111101110111101001001a1110111011111111111
0110111111111111111011111100111111111110111011111111101111110a0100111111111101111a0111110111001110111110111101011011011111101100111111111111a0111111011111111110
1101111010111111101101111111011111111111110111111011110111111a0000011011110111010a1111111001111111111111111011111111111111110110011101011001a1111111111011110111
1111011000011010011111111001101111011111111111110111100101101a1111111101110111101a1111101111011111110101111111101011111110111011111111111111a1111111001111111101
1111111101111111100111111111111111011100111110011111111110110a1011011111111110011a1110101111110111110111110111111110011101011111011011111101a0111011110111001101
0001111011111111101111111101011111111101011011110101111110111a1111111101111111011a1011111110111110011111111111011011111110111110111101100111a1101111111110111110
0010101011111111001111111110111111111101111111110111110111111a1111111111111011110a1011110101101111111101111111111111111111110111101110010111a1111101111111101101
1101111111110111111111111111111111110111011011011111011111101a1101111011111110111a1010111111010111001101111101011101101111111111111011111110a1110110111111110110
0111010011101011001111011010111110101111111011110111101110111a0111101011111011101a1111111101111111111101111110111101111111111111110111011101a1010101111110111111
1111110001111111111111110111111101111111111111111111111011111a0111100111101111011a1111111110111101100111111111111111111011101010101111110001a1110101111111111011
1100111011100111011111111111111110101001001101111111010001111a1111111111111101110a1111111111011011111111111011011111111101111011111111111011a1111111111011111111
