(111,62)(10,47)(5,65)(116,159)(51,19)(87,142)(60,145)(3,125)(0,78)(13,54)
(3,11)(102,87)(56,156)(13,4)(2,149)(104,5)(22,5)(119,112)(116,127)(117,89)
(69,76)
(70,85)
(7,1)
(10,115)
(27,63)
(101,145)
(115,79)
(103,117)
11122b1122110212111111111a11111a011111111111111011111111011110111110100a1011111a10111100110111011110121012212121102022112010121112010111111111011111110111010111
12201b0122221022001111111a10111a111111111111011111111110111011111111100a1101011a11011011111111111111002221001200112220211101212121111011100110101111010101111111
11221a2220221121100101111a10101a111111110101111111111111111111111111101a1111111a11101111111011111001001112100021220120212122111202111111111011110001110011100110
02022b2220212202111111111a01011a001110111111111111110101101110101110111a1111111a11111001111111110101210211222122012212011212021221111111111111101111001111111100
11212b1110102112001111101a01100a110011100011111111101111001111111101111a1111111a01110111111110111111202221220122222022212222210012111111111110001111111111110111
11121a1112222001110011111a11111a111101110110111101011101111111110111111a1011111a11111111111001001101122112200021101211012112101111111111111110111101001101110101
21222b2222212011111110110a11111a111101101111111101111101111111111111111a1011011a01110110111111001111222102202202212221110111022121111111110111111111111001011111
22122a1002201222111111110a11111a111111111111001111111111111111111100111a1111111a11111111011111100100001112011222011110101211112010111111011100110101111110110111
11121b2220122222111111110a11111a111101111011110111100111111101111111111a1111100a11111111111101101011012221222011122211212012111220101111111101110110111111011111
02222b1222221122111001111a01111a011100011111011111011111110100111111110a0111101a01111111111010011111211212202102222212221100011221111111110101111111101100111101
20120b1110212220111101111a11101a011111110011111111100111111111111110101a1111111a11111110101111110110211110102202022222221200121111100111111111111010011111111111
20201b2211102220111111111a01101a010111111111101111111101111001110111101a1110111a11111100111110111101022210110222221122212111202112111101111111111111101111111011
01011b2101022211101110111a00111a101101010110100121111121221110222200021b0012001a0011011111111100110111022011021122022012babbaababaaaaaaaaaaaaaaaaaaaaaaaaaaaaaaa
20111a1221201011111111111a10001a101111111101111121022222212211222210112a0212201a1111111111111111111011021112220121111121b121010112111101001111110111111010101111
12022a1020202202111011111a11110a111101111111010111011221111121102110202b0221221a0111110111111111111111102010121212100222b020201111101101101111111111111111111111
21120a2221201222111111111a11111a111111010001001102110121110012221221012a1010211a1111001011111111110021221121101012200111b022121022111110101100111111101111101101
21210a0010222112110011111a11110a111111111111111020110202201211122221220b2211001a1011111101011111111111022010202202200102a102001112111101111111111111101111111010
12121b0201110112111110100a11101a111101111011111112122211120121222121112b2212111a1111111101001111111012121120022101212222a121102201111111011111111111111110011111
21122b2111112102110111110a11111a111111101111111112111202020101112021111a2201221a1010111010111011100121101222212121100222b100222222111111101110111111111111110000
02222a1100122001111111111a11111a001010110110100022122112122211210111111a1200111a1111111111111111111122021022022210221100a112201011111100111111110011111111111110
11110a2201211211011111111a11111a111011111111111111211112100220111121021a2221221a1111111111111111000011211102111121101121a102112210111100011111111111111110100101
11222a2202212012101100110a11111a111111110101111112111122222021220122111a2021121a1111111101111011000121201221012212201222a202122111111111011111111111111111111111
01011a1111111111111111111a11111a011111101011110120222201111121022222221a2210211a1111011010001101111101212100112112202122b001222111100111110111110111011011111011
11111a0011011101101011111a11111a111101001111101122210220122211211222122b2120121a0101010111111111011101220121121210121122b210201202111110111001111001011011101111
11100a1111111101110111111a10101a101011101111111022101102211212202112222a2102211a1111110111111111101111102212121211210221a200201201111111111111101110111111111111
11111a1111100111111010111a11100a101110111011011122201211021122122011210b2022111a1110110101111111111010111111111111111111a011111111111111111111111111100011110111
00111a1111111111101111110a01111a111100111111100111011011012212102112202b1212120a1101000011111011011111011011001011111101a111111011111011110011111110111111111111
11110a1111111111101110111a10011a111111101000111002211112102212112211201b2101200a1100011110111111111101111111100011010111a111111111111111111111111111010111111101
11111a1111101011111111101a11101a011111111111111012121211101212102211211a2211121a1111111011111101111111111110101111111111a011111111111111111111101111101111111110
11111a0101101111110111110a11111a111111111111101120101122021122112122021a0021011a1111101111111110111101111101110111011110a111011111010010110011111011110111001111
11111a1111011110111111111a11011a111100010111111111112112221222212211211b1010101a1111011111111100111111111111111111110111a111101011111011110110111111111110111011
00110a1111111111111111111a11111a111010111111101122122111022201022022021a0112111a0110010111111110111111110110101111011111a111110110111111110010111110111110110101
11011a0111110110111110111a11011a111111011010011102120220122122221202122a1212000a1011111010110110111111111111111111111111a111111111111101111101111111011110011111
10111a1111001011110111111a11101a110111111111011122211110212211201112212a2022011a1111001110111111101101111100011101111111a110101111111111111111111110011010110110
01111a1111111011111100011a11010a111111110111111010012212201212221221001a2212221a1110111110101111100111010011101111101101a111011101111101111111101111111111101111
11101a1111111111111111011a11101a110111111110111122221112202021121021110a0220111a1101111110111111111011101111111011110110a111011110110111111011110111011101111110
00000a1101111110111101111a01110a001111111111111012012100212110020010211b1012121a1111111110101111100101111101010111111111a110111111011111111111111111111001010111
01011a1011110111111010111a01011a111111111110111112102222220120202212011a2122221a0111101001111101111101110101101111111110a111110110111101110100001011111101001101
10111a1111011111110101111a11110a111110111111011100021212121121222201221b1021121a0111101101111011011011111111111111011011a111111111111111111111111111110110111111
11111a1101100110010111011a01011a111111111111010120002122222122200200210a1112211a0101010111011011011010111111111101011111a111101011111101111011111011101001111111
01111a1011110010111111111a11111a010110111111111100122212222211102121221b1200211aaaaaaaaaaaaaaaaaaaaaaaaaaaaaaaaaaaaaaaaaa101111110111111111111110111111111111101
11111a1101111110011011110a01111a011111111111011121221112110221201112212b02220111111010111111111111111111111011111011001aa111110111111111111110101111001101111111
11111a1100110111111101111a10111a101111011111111111111111101111111110111a11011111011111111101011111010111111011110111111aa111011101110110100100111111110111111110
11110a1110111011111110111a11101a101111111111010011110111111110101111011a10111111111101110011101111011111101111111110101aa111000011110110011011011111111111111111
11111a1101111110011111101a11111a111110111101111101110111111111111111111a11111011111111110011001111111111111111100111011aa111111111111111011111101011111111111101
10111a1010110111110011111a11110a111011011101111101111101111111111011011a10110111111111111111111111111111001111011111110aa111110111011111111111101111111111101111
11110a1011000110111111111a11111a101110011101101110100111111110111111011a01110011101111101111111101111101111110111111110aa101111010111111110011111111011111101111
11111a1101111111110111111a01110a110111111111101010011111111111111111111a11111111111111011111011111100011010110100101111aa111111111111101110111101110101011111101
10110a0111111111111110101a11101a100111111111111110111111111111111011101a10111101101111101111111111111101101111110111111aa001111011111101001111111111101111111110
10110a1111011110111111111a11011a101110011101110111111001111101111111001a11111111111111011011011111010101110011110011111aa111111101111111101011111111111110110101
11111a1110111111110111111a01101a011111111111111101111111111011111111111a11110011111111101111101110111110011011111011001aa111111110011110110001111110101111011111
11010a1110111111110111111a11111a001101100111111110001111011111001100111a11011101100111011100011011011101011111111111011aa110110110111111110111101111111110110111
11001a1111111111011111110a11110a111010110010111111101101111111111111111a11111111011110111101111111111101111011000010111aa111011111111111101111101101010111100111
10111a1110011101111111111a11011a111111011111111111110111011111111011011a11111101010101111010011011111111111011111111110aa111111111111111011110111111111011111111
10111a1101111111011111011a01111a011011111011111110111111001111110221212a02122002211222101121110111011111011111110111111aa001101111111111111111111111111111011101
10111a0111011011111111100a01111a011111100100111111111111100110012122112b20202102012220201221200222201111111111111101111aa111011111001011110101110111101111111101
11111a1101111101111110111a11100a111011100100101111011110101102122101110a02122200222202222221020012020101110111010101011aa101111101111101111111111011111111101100
10011a1011011110101111111a01111a101101111111011111110111110012222220022a02102210222201200120012211120111111001100011101aa110011111110111110111111111011011011111
11111a1111110111111111111a11111a111111011011011111101111011112222021110b11122221212002221122111221021111110101011101111aa011111101111110111111111111111111111100
10111aaaaaaaaaaaaaaaaaaaaa01101aaaaaaaaaaaaaaaaaaaaaaaaaaaaaaaaababaaabb22222111120000222221112122211001101111111111111aa011011111100111111001100011101111111110
11011111110111111011011111111111011111111111101111111111111aaabbbbaababbbbabbbabbbbabbabbbbbbbabbaabaaaaaaaaaaaaaaaaaaaaa110110111111111110110111111111101011111
11111111010111101101100101111111111111111011111111111111101a100021221200012122122202222022222120210201101101111111111011a101101111111011111001001111111111111101
11111111111111101111111111111111110101001111111111011111111a021210100120201120201121021211202112220201111011110110101111a111110111100011011111111111111111011111
11010111111011110111111111111101010111111111100110111000111a122222010120122221221221020122220111102011111111110011011111a111111110111111011111111111110111111111
11111110111111111111111111111101111111111111100001110111111a102101222222222221122002222022211121201001110101110111110100a001101110111111111010111111011110111111
11111111011111111000111111111110101011111111111110010100111a112201000021202201220022122221211000202211111111110011111010a100111011111100101111111111101111011111
11111101111111111111010111111011110111111111111101111111111a122111221022102122221002102012211110201010111011101111111110a011111101111111011101111110110111111111
11011110001101111011111110001101101110101100111111101111111a111212212122002110022120021200001122011210111111111101110111a110110111101111011010110111110101111111
11110111111011101111111111111100101111101101111100111010111a012021112121121222020221222012011101122010011101011111111111a101111101011111110111011111011111101111
11101111111110111110111110101111111011111111111011111111111a120122221201200221020212202221211100122211111111111011011111a101010110011110011110111111101100011111
11111111110111011111111111110101011111111011111111101110111a101120202222222120002212022120012100222010111111110010011011a111101101011111011111111111110110111101
11111111111101011111000101011011111110011011111111110101111a121122202112102222222221221222112122222201011111001001111111a111010100111110111111101111110111111011
11101111111111111111101111110111111011011111111111001111111a1221122120122222212022212222202222212212aaaaaaaaaaaaaaaaaaaaa111111101110010111111111111111111101111
11111011111111111111111011111111100011011011111111111011011a1012102122122222022210221220011111210211a11111111010111011111111111111101111111110111111011111111011
11111011011110101001101010111011110111101111101101111110111a1222002212122011122022222202102122122210a10111110111101100011111111111111110101110110111011011111111
11101110110111111111111001101010011111001101011101111101101a1022011222000022212112220222022122120211a01111101001001111111110011111011111111101101101101111111011
10101111110011111111111100111111110111010110000111101011011a1022221202222221221221212202222011120201a10110011111011111111101111111111011110111111111110111111111
11111110111111111111101111010111011110111110101101111111011a1120222221122102200201122221021201010220a11111001110111111111011111101111111101101011111100111111111
11111111111111111111110111111101101111011100101011111100010a0121021202110110212022022022222210122222a11110111011111001110011111111111111110111011011111111101111
11111111101110111100111111110111101111111111111100111011011a1212212202022121222201022102221222211110a11101110111111101011111001111111111111001111110110111111111
aaaaaaaaaaaaaaaaaaaaaaaaaaaaaaaaaaaaaaaaaaaaaaaaaaaaaaaaaaaa1011121110021211221122221220221222101112a01111000111001101111110111101011111110111111111011101111111
1110111101110111100111111110111111111111111111101001111111111200222212122001220022222211022201100112a01111110111111111101011011110110011111110111111111001101111
0111111111111101111111101011110000111101111001111111111011111112122112222020220220212222121012101110a11111101111101011111011110111111110111111101111000111111111
0111111101111111111101111011011111111101111111111111001110111110212212221122022211221122222200201110a11111100101111111111110111111110111111011111001110111101101
1011111111111111111111111111111111111011111111001111011111110110111011022112021112212021202221102221a11111110111110111111111101011111001111111111111101111100011
1011100111111111011101111011111111101101111111111111100111111111101111110111011011111111111111111101a11001001110111110111101111101110110111101001111001101011111
1111101010110111110111011111111111101101001011011111110111011110011101101101110111111111111011111111a11101111010101111111111101111111202212121212120201222020221
1011111111110111111110101111111111111111111011101111111101011011111111101110111111111111011101111110a10111011111101111111011111011211011021120212101012100121122
1101111111111011110101111101011110110111101111011111111100101101111101011111011011111011100011101111a10022011201210101111122001002221110221221222021100211111122
1111111111111111111100111111111101001111111100101110111111111111001111101101111111111011111111111010a02221211222101221021222211210221120012202122112122212111010
0110111111111011110111111011011101111011111101111111111100111011110011100111110011011111001100101110a11120221222212212202221022201210212121101222121221220221221
1101101111111111111111111111111111011011010011111011111110111111101111111111111111111011101111111110a11112121211102112102211202121210110112120222022112112110022
1110011101110111110111011101101101111111111011011101110111110111111101111111111101101011111111111110a12112220212211201112112022112111112112211110112210121112001
1111100110110011110100101010111110111110011111111101111011111111110000111011101111111111111100011111a11202011210121212200222000122121212220110022120010221222222
1001111110011101111110101111111111110011101111110111011111001111111110111111111101111011101111111011a11222211011011111112100110111222211111111121121222102012211
0011000101111001111111111011110110011101001111011100110101111110111010111111111111110011111100111111a02101212120201212100222101021220000221222220122010121121120
1110111010111111111110011111111111111111111111111111111111100111111111111010110111111111111111001101a12111222120110120020221212211201202121010101201211100101211
1111111111101111101111111011101011111011111101111101111011111111111010111101011111011111101111110111a10100122212202001211122222210021202112212120222121120121112
1111111110111110111111111111111101111101111110111110101101011111111111100000101111111101111001111011a02222211222110212021110221221102221221121120110121121100121
1111110111111111001111101111010010111111011111010111111101111111111011001111101011111101111110110111a12022122002022011102200222222121220211110120122121022011121
1111001111101100101111111111110111111111011101111111000111111110220002021122221220111201001010111110a02022101121210112012102011020221222001112021112210112220121
1101100011101110111011000111111101111110111100111101111001111101000220222120220212121012212121100111a11212020112222001221212111221021100211112221222011020100111
1011011111110101101110111011110111110011111110001100111110111111021111211222111001120112121011011011a10212212122112012001012110021022102121112111221011222211200
1111110111100001101101111101111101100101011101111011111100101111212212120220220101011221111201111101a12200112021022221120222102211022211212022121121121021002010
1100111111111111111111111101110101111110110110111111111110111111121111122011201021221222221211101111a11001021101102211222210012221222202021111121002200120200211
0111111101111111111110111111010001011110111111111011101101111111011120201112202211222122220220111110a12111022112102220021112112121022122212022220021120110002122
1111111101011011111110011111111111101111111111001011111110111111202112121221111101011021202222110011a11211101212122101121111102211020220012222112011210122222222
1110111111101010110001011111111111011111110111111100111111110111221210010112112221011212222121111111a10211121122201221011012110122211102222102011220202121201122
0111101101001100110111111011111110111111110100111101110111011111211201200201220110112121101221111110a11112122120012022221222101212211222222222122220221012110212
1111111111110011111111110111111100110111110111111111110111100111221122111112202120201112202110111011a12210120020120212020212100221120110101111101111021121020122
1101111101111111101110011111101101111111111001111111101111111101121202121121222002110211110220011101a12210112122111202211212222222102202101110221112202002212112
1011111111111011101011111111111011111111111011111111111011110111220212021022122221212021021201111111a11211221210202110202201221212212011220200220111121010212220
0110111101111111111101010111111111101111111111111110100111110010211211020022210001102211211111111111a12202222222212211121112212222210120110212110220101101202221
1011101111110111101000110111110110111111111111111111110111101110012112112220020012202201002022111111a10102202212102101210111101110222210221001110122221212122202
0111111111010010011111111001111011111110111100111010111111101011020111111221202211221202120222111111a11121201122210012211202200210120201221111021011020202121212
1011100111111111111111111111011111111111111111110111101111111111112022111002211112211211021222110011a10121022102211212121121221012222120200121021120122120010121
1100100111111111111111111111011110111101001110111111110111111110020211021012120120102212122201110111a00020112211221111202122221221211101110011111111111010111111
1011111111011101111110010111111110101111111111101011111101111111212112121222002222212122112210111111a12221212022011101111221122212101010111011111111001111101011
1001011111111101111110100111001111110011011110111111110011111101102220021112121110112201011121101111a11110111011111111111111110111011111011001111111111100110111
1101111101111111110111110111111111111011111011101111010111110101121101001112112220021111221200110111a11011101110110110111111111000101111111010110111111111111011
