(0,145)
(118,28)
(43,133)
(101,48)
(28,36)
(71,71)
(30,33)
(81,57)
(21,158)
(92,73)
10101111111110111111101111101101111011111110111111111111111a1111011101111111111101110101a11110110111101010111101110111011111110001111010011111101110100111011111
01111011111111111110010110111110111111111100111111101100111a1111110101111111111110101111a11111100011111110110111111011111111111110111111111010110111111111110110
11001111111010111111111111111110110110111111010110111111111a1111011101111101110101111111a11110101111111101111111111100001001111110111111011101111111111111101111
10111011111010110111011111011111111111101111111111111110111a0101111110011101111000111111a111111101010111010111101011111111101011110001111111aaaaaaaaaaaaaaaaaaaa
11111111110111011011111111011110010111110111111101101111111a1111111111111100111110111110a110111110011101111110111011101111111111111111110001a1101111111111111111
11111111111111101111111111011111110101011101011101111011111a1111101111111011101011101111a111111111111110111110110111111100111111111011001101a0011000001111101111
11111110111011111110111111111101110011111110110110111101111a1011101111101011111111111111a111111111111111111111111111110110111111111111111110a1121122212011012100
11001101111111110111001011111111101111111001111111111111101a1110111101111101111111111111a110111011101101111111011111110101111111101110111111a1112222112222102200
01011101101111111111011111111111111111101111011110111101110a0100101011111111111110011101a011111111111111111111111111111111111101111111111110a1122111011112222212
11111111110101111011111100111011111011001001111111111001001a0110111110111111111111111101a111111110111111110110010101101111111111111111001011a1101010112112012011
11000111111011110111001111110111101111101111110111111110110a1111111111111011011111101011a011010111111111011100111011011111110111111111110101a1101122212122112022
11111111111111111111011011011011111110111101111111110101101a1100111110111100111101110011a010100111111111011111101111001111111011111111111111a1011112212110221110
11001110111111111110111011011111001111111111111111111011111a1110100111111111110111111110a101001100110111011101111101100000111111010111101101a1111212221222121122
11101111111110011111112121120211102212112200100020111101111a1111110101110101101011111011a110111100111111111111101011111111111110111111111111a1121101212212101212
11111011011111111110121121212111221102220221201220211110011a1110101111011011011111101101a111110111110111001011111111101101111011111111111110a1121122122112222110
11111111000111111120012122221212222222222120021120001011111a1111100110111111011111111101a111011110111011011111111101111111111111011001011001a0111111011012111110
11111111111111111010122212220021212122001220211120111111111a0111101101111111111111111101a101111001101111101111111110111011001111110011111111a1102121222221202201
11110111110110111020112122222222221222012222222022211111111a1101011111111111110101111111a011111111101110111011111110111111111111111111111111a1001012220202212221
11111011110111110111202222220211020222202121201222211111001a1111111110101111111011011011a110011010111110111110111111011100111111110010101111a1100111012112020111
11011011111100111121220012112022222220210112112212111001110a1111110111111101111110111111a011011111111111111111011111111111111111110111101001a1100012120101102121
11111111110111110112022210210012012022122202210222211111101a0111101101111111010101111111a101111011111101111111111111111111101111011100011110a1112222122212211210
11111111111111111010020111120210212222202022200202111111111a1110011111111101111111111011a101110011111101101111001011011111111111101111111100a1120222112202122211
11111111010111011101122002021220020221222011121201201111111a1110110001101011111011111101a111111111111011111001011111111011011111101111101111a1121022220110110121
11111001011111100101022202212222222022022222020222100101110a1111101001111011110111111110a011111111111111111111110110111111111111011101111111a1121202201120220022
11111110110111111011121012210222222122222122022010211011111a1111101011111111110111111111a111111111111101111111010111111111101111111111010111a0011102022222211212
11111111111101111102121122102222022221112012222211011101110a1111111100111110011111111101a111111111111011111101110111101111010111111110111111a0112122212202020122
00011101101111011012002022122100012200222122220222111111011a1101111100111011111011101011a111011101001110111111111011111111111101101111111110a0120020020211122201
11111111111110111120211200022222221221220220222012201101011a1011111111011111110011110011a101110110111101111111111010110001110111111011110111a1122221021011212110
11111111111101010110211202202220201221222022210112110111111a1111011110011111111111111111a111011111010111011101110111111211122212212211102110b1121220121221121211
00111111111111111100222222222022212222002021021212111111111a1111101011111001111111001010a101111110001111111110111011110100210111221111020121b0212002111202010111
11011101111110110021122122222202222122120222221111111111100a0111111011111101111111111001a101111011101011111101010111112012102220012222112122b1110122221221211101
11101110011111111110222222220122212222021022021212211111111a1111110111111001111011110111a101111111111101110011111011012021122012220001100110a0210210222201212210
11110101101111110100222221210222222210102222200212211101111a1110100111110111011101110101a011110111111111011110110000112122102021201202021122a2210021001212211110
11101111111101111120212122222220022222202222022000211001111a1111111111111101110111111101a000111110111010111101111011110112012111121121220121b0102222202020111121
11001011101110110112022120222222222022221200122121011111111a0011111111101111110111111111a111010101101011111111101110111201121110220211102212b0202101210210102212
10101110110111010122122202022220012000020001212221211010101a1111111111011110111111111101a111111111111110010111101111100110212111212110222100a2022211111210120212
00011011110001111110122022100210002222212120222211011111111a1111101111011111111111111101a111100111111101110111111111110022121021222022100101a0000021111111111011
11101111111111110112021021222221220110221121222111211111111a0011111111101111111001111111a111110111111111111111111111111212112111221111022111a1221120011111110100
11110111111111110001220222222122122222222211201222210110111a1001010111011111101111111111a010001111011110011111111111110211010111111110100201b2001110101110111010
11111110010001111122110211222221010221102212212220111111100a1111110111110101001111010111a111001110011111111101111101111011122122210122220211b1021211111111111111
11011110111101101121220222221102221022222222221011210101111a1111111110101111111111111101a111010111011111111110111111102222122011200102021011a2222111111111010111
11011011111111111020210202012222211122222201222022211101011a1111101101111111111111011111a011111110111011100101110111112110110122021221221122b1221111011110110101
11111111110111111121110200020222121202111001222121011101111a1110111110111111111110111111a110111111110110001110110111101121220011222112010021b0022111011111110111
11111010111111111021022212211101111111010122010011111011000a1111111100100111111101110101a1111111011101110111101110011120baaaababbbabbabaaaaab2121121110111100101
11110110011111001122122220210001112122222210002011011110001a1111011101101101111111101111a0111110111111001111111101111112a212022111120110220112102221111001111110
01011001111111001111111110111111111111100111011111111111101a0110101111011111111111101111a1101111011111111111111111111122a222010122220200122220020121011110111111
11111111111111111101111111001111001111111011001011111111110a0011111000111011111111111011a1000011111101011111111011101112a021102202221201112212111102110110111101
11111111011101011110011100101111111111111111110111111111100a1111111110111111011111111111a1011111001111011111111011111102b121211021101212010101122212111111111111
01101111011011011111111111101111111110111111111011111111111a1110111011110011110111011111a1111111101111011111111110011012a202112202212200121212212110011111001100
aaaaaaaaaaaaaaaaaaaaaaaaaaaaaaaaaaaaaaaaaaaaaaaaaaaaaaaaaaaa1011111111011111111111111111a0111110111001110011101111111111b220022122110011111012111212111010111101
1111101111111111111011111111111110111011111100111110111111110101111111110111111101110111a1111100110111111111111011111111a001100211211121120212022010111111101111
0011110111101101111111111011111111111111111111101011101011110111011110100111110111111101a0111111111111001100111110111112b122000212012102212121112102111111111111
1111111111011111111101111101111111011011101111111110111101011111111110111111011111011110a1101111111101111101010111111110a120201212221211222212021011011111100101
1111111111110111101111111111111101111111111111111111011111111111111111111111111111111111a1001111110111011111010011111121a121121001122111212202002120111111111011
1110111111001110010110111111100111111010111111011110101011111111111011111110111101110101a1011111111101101111101111000111a120022112110112011221211200010111111111
1111100111111111101101111111001111011010111111111111101001111110110111111111111101111111a1101111111101011111111111110111a221111122210212220111011112111111111111
1111111111111110011110111111111000011111110111111100110122211121212222211222200020200211a1111111111111001111111011010011b021222111121022010020122202010111111110
1111011001001111111110111111001111011111111111111111100112011022021211022022202101111211a1111101011001111111110101111101b102211221201220201200101102111101111111
1111111001111110111111111101111111101110111110101111111121201122111112022210212222212011a1111111111011111111111111111101a111011111001111111011111001011101100111
1011111111111111011111111011110110111111111110011111111122110221021120112212121221112011a1101111110111101111010111011111a111111111101111001111111000100101011111
1110010111011110011111101110011111111111111111111111111102221111011212101212122222102200a1110111011111111110011111001111a111110011111111111011111111001101111111
1111110011111111001111111110110110111001110011101111111102122010020111012122221121010211a1011110111010101111101110111101a111111111111110111010111011111111111111
0111111111111111101111110010111111111111111011111111011121221221211111112221120120000201a1111111011111111111111111111100a100001111111101101111101011111111110111
0111101000011111111111010110111011110111111110011110110122221122121011112222211102012211a1010101001111001011011111110111a101111110111110101110111111110110111101
1101111110101111011110110111111111110111110111111110111102220121122111112212122102202111a1111110111011111101111110110111a011111101111111111111100111111111001111
1111011010111110111111111111101001111111110011111101111122002211221112222212212221110110a0110101111111111100101111010110a110101111111111100111111001111100101111
1101110111110111111001110111111111110111102101212010222210200222122220022212120012211110a0010011111111111101100111100111a111111100111111111111110111011111111101
0100111100101110101111111111111111001011111211121222112100020021222211220201011211122111a1111101110011111111101111111111a110011101100111100111111111100011111101
1011111110110111111111111111011111101101111011111021211222010200222012222220022210201011a1111101111111111111011010111000a011110101101111111100111011011011011111
1101111110111111111010101101111101111010112221012222212221022220222220112222210022212101a1100100110111111111111110101111a101110111111110111111111111111111011111
1111111011100111110111111011111111011111111220211212221222111121122220200112211022122011a1010111111110011111111100111111a111111110111111111111111111111001111010
1111111101110111011111111111111110111111112210212110221122202212222121212100112211220211a1111010111011111111111111111010a111110111000111111111111011111111011111
1111011110101111111011101001111110111111101010100012000222002222102210220121221222112111a1011110100111110111010111111111a110110101011111111111001111011110111111
1111001111010011111111111010111111111110112222120221221120212222020222022122011220120111a0110110010111110110111011001111a111111111111011110100111001100111101110
1111101110111111111111110111111111111111010201112022221022201222012220222011222112122111a1110111110110101111011111110111a101110110111111100101111111111111011110
0111111111111110011001011010111111111111111101221202120222102120200202222222122112221010a1111111110010110010011011001111a110011011111110111111111111111010110111
1111001111111111101111111110110111110111102120121211210222222001002121112121112222102211a0111111011111101110101011101111a101000101111011111111111111111111101010
1001111111110111111011101111111110111011112222221212001201220122202202200220201222120112a0101111111111111100111111010111a111111111110101111110111111101001111111
1111111101111111111111110111111101110110112122220021101022222210222222202000212120210200a0111100110011110111011111111010a111111110111011100111111111011111111111
0110110101001111111101101111101101111011111102221112210012202222122202212211020202222211a1111111011111001111110101111010a110110011111101011111111101011111111111
1011101101110101aaaaaaaaaaaaaaaaaaaaaaaaaaababaabbabaabab1122222222122222222022212210222a1111111111111101011111111011011a100111110111111110111111111110111101111
1111111111111111a111011011110110110101011122212202212121b1222220022210001221000202102211a1111111011101011111101011111111a011111011111011110101111011110011010101
0111111111011100a110110111110111111110111121212112122011b2222222112122222120212020220022a1111111010000111110101111110111a111111111010111100111111110111111111111
1100001111111111a111111101111011101101101110101111221121a2202222211221200002122222222222a1111111110101111100111111111111a111100111110011101111111101111010111111
1011110111100011a111111011010111111110110111220211222120b0222222222201222200222012122221a1011111110111101011111111011110a110111111101111111111101001111011110110
0111011111111011a011110111111111111111111102122201000022b1220220222022221121222221202221a1011101011101111111010111111101a111010111111111111110111101001001111101
1111101110001110a111011101111111122102122022100012121122a2220222122221212121102212211110a1101101111101110011110011111111a111011101111111110111111110101111111111
1111101110111101a111110011101111102221122102221222222012a1222212022201021101210102222212a1111110111110111111100111111111a011110110110111111011001111101111011111
1111001010101101a100111110111111102120202012222222102020a2222122111220222122220022122111a1011111111101111010011111111001a111111101111110110101110111111111010011
0011111111011110a111111011011111102212102222200222212122b2122220202222112120101122101012a1111111101110111100110111111110a111110111110111111011111101111111111101
0101011111100111a111011111111111122002112102200122222202b2212222022122221201211111022010a1101111111111111110111011111011a011011111111101011101111111010111011110
1111010011011111a111110111011111122022101010222222222222b2222211222020122212201201011212a1101111011110110111110111111111a111111011011111111101111111011111111110
1011111111111111a111111111111110112021122122022222202222a0212222221122022112202122201110a1111010111111111110110010010110a111110110101111110111101111110011111111
1111011111111111a111010111110110010212202220222222222222a2222122011210221112202021110210a1111111101101101111110111011111a010110101110111110110111111111001111100
1101111111111111a110111011011011120210111102110122122202a2021022210012221022111211012222a0111101100100111111110111001110a011011011100101111111011111111111111111
1011101110101111a111111011111110121120212202222202221200b1021020212022222120011122221212a1111111111101101101101111111011a111111111110110111111111110111011111011
1111111101111111a101101111110100111212201020110211201212b1122200212201112220210102002101a1111110111010111111111111111111a110111111111011111111111111111110111011
1110011110111110a100111111110110110221212220110221122021b1201211222120120201011210212221a1010111111111010111111011111111a111111101011110011111110010111111011100
0111111111011111a011111111101111121101211221120112222200b2212112211111112112212100121211a1000111111011110111111010111111a111011111110110111111101011110111111111
1111111111111111a111111101111111121212020012101110210111b1220212211111111222201201221112a1111111111101110111111110111111a001110111000101111111101011111111100101
0111111001111110a0111100111110010021abaaababbbbbbabbabbaa0221020212221002121221201221212a1111111111110111111110111111011a101101011011111111111111011111101110101
1101111101110011a0111101000111111010b220221220121112002102102201210110120221221012222212a1111111111111010111111111011111a111111111111011111111011101111111111111
1111110111111110a1101001111111111211a201122202212212121011220221110221121202000101210110a1110101111111111111111111111111a010011110111111111110111111111111111111
1110101110111111a1010110011111110020a122112212020210012221002021211211221010211021202011a1111110111111110111111101111111a111111011111110111100101110111111111111
1111111111111111a1111011111110111122a220122110212021211101202210221212200022211211211002a1111111111011110011111110111110a110111111111100111101100111111111101111
0110101111011001a1111100111011111211b212012110211021210112202221102021212122122112121220a0011011011111010011101011111001a111101111001111101110011011111101111111
1011111110101010a1111111101111111200b222212121212212122210222221211121110012202211221020a1101111011101110111111111111111a111111101111111011110111110110110110111
1011101111011111a1111111011101111222a002012121022010222110121221011111111110111111011111a1111111101111111111111001111011a111101111101111111111111101110111111101
0111101111111110a1111110111101111211a121211202220011012122211110110011110101111111111111a1010001111111101011110111011111a111001110011101110110110111111001111000
1111111111100111a1101111110111111221b121111222210202122212221021001011101000111111111110a1011010111111111011111011111110a111011011011111110110111111101110110101
0011111010100111a0111111011111111220a002002110122211010211221021111111111011011111001111a1110111111101111111111111111011a111111011111111111111111111111110110111
1111111110111101a0111111111111110212b011111122010122200012111221111111101111111101101111a1111111111111101101111110111111a111001100001111101111111111111110111111
1111111101111101a1011101111111111221b221222210101221111220212011111111111111111111110111a1111101001111011111111111011111a100111010011111100111111101111111111010
1011111111111110a0111111111101101221a101012122220211112120022220111011111011101111111111a1111110111101111110011111101110a111101111111111111111111011110111111111
1010110111111111a0111101111010110111a121211022100221111112200111110011111110111111110111a1101111111110111111110110011011a110111111101111111111011001111100011111
1111011111011111a1110101111011111021b121222111112121021021112101101101111011111111001011a1111111111100110111110111101111a010111101011011101101011111110100111111
1101011110011111a0010110110110101101a111111111111100111111101110110111111101111011111011a1111111110111111111100111111101a110100001111111101111111111111111111110
1101111111010111a1011110111011111110a110001111111111111110111101001111111100111101001100a1111101011111010111111111111111a001011110001111111111011101111111110111
1110101111011110a1101111110011011011a000111011011101001101011111111011111010111111011111a1011101101111001111011111111111a111110110010000111111101111111111111111
1101011111111110a0111111000111111111a110101011110111111011111000111111111111011011111111a1111111111111111011111010111111a011111111111111111111111111001110101111
