(18,6)
(88,140)
(90,44)
(26,91)
(32,25)
(32,81)
(27,73)
(36,92)
(48,82)
(67,99)
11111111011111111111101111101111111011a1111110111111011101111111111111111110111111111111110101111111111110111011111110111110111111011111111111000111101101111110
11110110011011011101111000101111111101a1101110110011110111011111101111110111101100110111111110111111011110111011011111111010111101111100110111101111100111111110
01111111111111111111111111011101111111a1111111111111111110110111111111101101110111111111111010111101010110111111001111011111111110010011111001111111111110111111
11111011011011111110111110111111111111a0011011111101111010111011110111110111110111110111101011110011111101011010110111110101110111001011111101111010111111011111
11111111111111110100111111111111110111a1001111111110111110111111111011111111110111111111011011011111101110111111110111111111110101111111101101111011001101111110
01101111111111101111101101111001111111a1110110111111101111110111111111111111101101011111111110111111011111101011101111101110111111111111111111110111111101110111
11111101111110111110111111111011111111a1111001101111110111111101011111111101111101111111010110111110011111111111111101111111101111111111110101111011111101111111
00111101110101111111011111111111111111a1011111010111111111111111011110111110111111111111111111111011110111111011001111111111001111111101011001110111011111111001
11101111011111111111001110111111111111a1101101010111111111111110011010111111011011111111010111110011101011101111111111111110111101111011111011110111111111110001
11101111111111110111111100100111111011a1111111101111011111101011110011111111110111111011101111111101101111111011001110100111011011111101010111101001101111011101
11110110111111111111011101111111111111a0011110111101101011100111101111111111110110110111111110111111011111110111110111111111101111111111111111111111111110111100
11101101101101111111111111111101101111a1111111111111111111111111011111110111212120210002120111211220202021111110011111011110110101111111011110011110111110111110
10111001111101100111111111101011100001a1111110011101111111202111011200221210222222222002221222121120110210111011111111111011111011011111111110110110111011111101
11111111111010100111111111111111101111a1111011111101111110221211202122110211210222122112221211102001210200011101111111111111111100010111110001111111111111111101
10111111111110011110011111011111111111a1111101111100111111120210022210211021222110201212111222220222112111111101101111111110111110100111111111010100111110111011
11111101101111111111110111110111111111a1111101111001110101122222210211022001222222020212222122112211202120111111111111110101111111010010111010111101111011111101
11011111101111110101110010110111011111a1101111111111111111122222201111021011220211222222122110111022121120111010101111110111110111110100111111011001101111011111
11111011110022211202021121201211111111b1101111111010111110202012222022222102222221202102222120121122111221111111111010011111101101101111111011000111010011111111
10011111110102210122211021211212120222a1101101011111111111122102212212222022202102121002222222122212101212111111111011111111111110111101101101111101101111101110
11011111101201112002110010221021001221aaaaaaaaaaaaaaaaaaaaaaabbabbbbbbbaabbbbbbbbbbbbbbbbbbabbbbbbababbabbaaaaaaaaaaaaaaaaaaaaaaaaaaaaaaaaaaaaaaaaaaaaaaaaaaaaaa
1010100111222211112212122011011221101011011011111110111011222102010202222112222122200222022222200112122220111111110101111001110111111111110110111111100111111011
0110111101011101021112212222120111121120111101111111111111221221110221102100022202022220022002021222100222211100110011111111110111111101101011101111110101011111
1111110111012212110212102022212112112211111010111010111111112121222220221220220222202202221222222101022122211111111110111010111111111110011111111111111110011111
0101111110202010022021212022112210022021111101011100111111112112200222212221020202202122200222202222222222211111101111011111110111011111111111101111110010111101
1101111111021122122211212212111121220211111110111111111111222102122222200021202222000221210220221202201122111111111101110010101111101011111011111011101111111011
1111111111221021101122212221221121112022101111100110111111021101211202022022022222222222220221222222112202200111011101111111111111110111111101111101111101111011
1111110010012201212222210022012102122200111111111111010111220111120210021102222222222022202222212222222221110111110010011101111111100010111111101111110111111010
1011111111112011211111010202100022211112111101111110111111212122202201212220222222222220202202220202121121111111111111111110111111110111111100001111111111111110
1111111011020122220121112211221212121222111111010111111111212202112222120222220122220122010220120222222122111011110111111101111111111110110111011111111111111111
0010111111101111222221222221112222012201111111111111011111212210222101102211222222222202222120220101212012011101011111101111111101101110011011111011101110011111
1011101111110121111112212112220121001111111111111111101011210212122212122220001220202222020220021220222100211111101111110111111111111111111111111101111011101110
1110111101201221122020211110111102212121111111111110111111220212122220202222212020022222222222120222022111211111111101011101110111101111111111111111111111001111
1100111111212111022101120022201212112012110111101111110111002222102222022222202222012222222020211222221222101101010111110101011111101111110111111111111110101101
1111011011021200202200121212211112110210001101111100111110021100022222201220222220222200202222220022202202111010111110110111110111111111111111101111111011111111
1111101101120120111101112000010002212111101011011111111111111222102222202222222222222122200222120021222001110111101100110011111111111110101111111101100111011111
1111111111121122101222210121202122222120011111010100111100012112222202022222022222222220222222202122221122011101110111111100111111111111011111111111111000101000
1001011111112101101221011121211212021212011111101111001010120102000020211000202022222022202222222112120222111001111011111101101111011111111111011110101101011111
1111000110111101012122122221111222211222111111110001111101102010211220222222222022222022222222021102202212211100110111111110111111111011111111111111011111111010
1011111001212222000abababbabbababbbababbaaaaaaaaaaaaaaaaaaaa0111112101222221102222200222122202212212222012011111011111111111111110111111110111111111101011011111
1111111111011002110b221022110221221102001101111111111101102b1112101220222221222020222022120222022222222112201101111011111101111110101110011011111111110110011111
1100111111112112221a201211201210221100211011111111111110110b1222222020222222202222222222012202222022202121211101101111111111110111110111101111111110110011111111
0011111111120100022b212011102101110212011011111010110111110b1110022220002222022222222202122220221122201222111111011111100110111111111011111111111110110111100111
1111111100121210222b011112101211212221221111011011111000111a1111010021122202222022222222210020211222222111011110111101111111101111111111010111101110111111111101
1101111010021222102b210211221220122220121111001101111111111a1111111212120020222222212220122222021011201110111011111011101011011111101110101111011011111110111011
1101111111022212112a100111221202211211211111111111110011111a1011100112221201220000222002222222212110001121111111110111110101111101001111111111111111111111111100
1001011110212221011a122020211011120111220011111011011001110a1111112222211222022020222222222210210020202122211111111110111111101010111111111100111111111101111101
1111110001201012200a212211211122111120000111011111110111110a1101112222202022222022202212202220221112122210111011101110111010111110111110111111111111010010111101
1111101111011111111a111110101111011111111111111111111111101a1111111221012021122122002212200212210111112022101101111111111101111100101111111110110011110011110101
0011111011001111100a111010011101111111110111111111111011110a1011011010212102120220211111212121222122201000110101111111110111110011101101001101101011101011101101
1011011111011111111a110101101011101111111111110111101111001a1011110211221212220120221222222202222002110121111111111110111110110111011011001011010111110111111111
1111101111111110110a111111111010111011111011111101100111011a1011111110211210122222122202221122222111021212011001000111111111101111101111011101111001111101110111
1111111111011111111a111111111111110111111111111111110111111a1011111021111111211210221121210012012110111111111011110111111111111111111111101111011101111011111101
1010111101011111111a111101111111111101010111010101011111111a1111111112221121122201221112022020222211121001202211011111011111001111110110001111111011111101110111
1111110111111110111a101100110101101111011100101011111011101a1111010112020211111101112201222222222112022120101012011111011001011111111111110011111100111101111001
1111011101011011011a111101110011111110111111111111000111111a0111010011221112222222112221212020200211200212221101111111011101011111110101111111101101111110100111
1011111111110101110a111111011011110110111101111111111001111a0011101102122222111221011222202200112122210112100010101111111111111110011011101011101110111011111101
1111010010001111111a111111101111111111111110110100100001011a1101111111112220121212022221122012221201211122122222021111111111110111111111111111111011110111011111
0111111111110111111a111110111001111111111111101101110101111a1111111201110111220121012200222021202111222112112221220100111111100101111111111101101101110101111101
aaaaaaaaaaaaaaaaaaaa011001011101000111110111011101011111011a0111110120121111001111011022220222222222111110222221021011111101110111111110101111011011111000101011
00110110101111101111111111111110011101111111111111111111110a0111111112122121111102212202120122220112202100012111110111111011111111111111011000001110111111011111
11110011011011111111111110111110101111111111011011010101111a1111111110202100101210222021222222220121112101211112021001111111111111111111011111111100101111111101
10110111111111001101011101011111110011111111111111011111111a1111111121221110012121222021220222102121121022012121111101111011110100111111011000101111111111001110
11011101110111111111101111011111111111011111111111111011110a1111011222011110222121221222222022121222220112202220211111111111110111111011111111111101010111111011
11101110111101111100111110111011111110111111111101111110111a1111111101111111111111112201122222002012220121212211121011011111111011111111001111111111111111111111
10011011111101111111111111111111111110111001111110101111011a1101111111111111111111112022210121121122120110112211210111101111111011111111111110111111111110111110
01101111101110111100110001011011111111111111011111100110111a1101111111110011101011112221112111202221220112222102211101111111111111111111111110011011011111111011
11111100011001111011110111101111011110111111111111110111110a1110111111011111110111110102212211210201121111211112121010101100111111111111010101011101111111111111
11111111100100111111100101111111111101110110111111111111111a1110100111111111110101110110101210221112020221202010211111111110011101111111101010111111001111101110
11111011011110101111010111011111111111101110111011001111111a1111110111101111111111112112210222021120002210212212011011101111111011111101011100100111111111111111
11111111101111111110111011110110100111111011101111111110101a1111101111110111100111112201211112200122201121121021221110111110111111101101011110111011111001111111
11101111111011111011101101111111101111101111101110110101101a1111011110111111111111111001120102221222112000211101110111111101111111011110101110110110111001011111
11010111111100110111111011111101111011110111111101111110101a1110100111111111111111112221201221110210102201010112100111101101101111111011111111111101101111111111
11111110111111100111111101111111111111111111110111111101111a1101101111111101101001012201121011110111222021221222211111011101111010111111111011011111111111111011
00101000101000011110011111111011101111010111111111010111111a1101111011000110110111111010212122121112122210222122111011111111111111111110111111011110100111111101
00101111111111110111111111101010111111110111010111101100111a1110111011110111111101110221221211122221201102112121221111101011111000101111101010101110101101111110
11101111111101111011011101110011121121022102202201221212221a1111101101111110111111110121111100112121211122211112111101001111011111111111101111111011011011111111
11101010011111101111111101100222211221021112112211022220111a1110111111111111111111112112221001122212001112110112211111101101111111111110111111111011111001011111
11010011111111111110011100111101122200211222122102110111212a0111110011011111111010112222211101112121100222222222221111111010011011111111110111101111011111111111
11010001110111111111111101110202212021012221102102220110221aaaaaaaaaaaaaaaaaaaaa11111202202221212222021111121121100111101111111011111110111111111111111110110101
1000111111110111111111111110120121222221112221222111111102211011111101011111111a11112202102211220221201211221211001101111101111101111011110001111111111110011110
11111111111101111111111111111112222220babbbbabaabaabbbbbabaaaaaaaaaaaaaaaaaaaaaa11aaaaaaababbbbbaabababbbbaaabbabbaaaaaaaaaaaaaaaaaaaaaaaaaaaaa11110101111001111
11111111010111111101110110111112010210b211120122221102111210111111111111111110aa11a10020211201022201212010222221210011100111110011111101011101a10100111110111100
11111111101110111110111111111111221200a012012211121222121121111111111011111111aa11a01111001101110111111101111111111101111101011001111010101111a11111010110000111
11111111110111111111111111101220000011b212122110111222102121110110111111110111aa11a11110101101111101111101101111110001111111111111111111101101a01111111010001111
11101110111010101101111011101120221211a011121202022221110201110110101011111111aa11a11111111100111111111111011011111111111111010111011111111011a11111110111111111
11101111111011111011110011101122101122a100201221000111111210111110111010111110aa11a11011001101111111111111010101111111110111111111111110101111a11011110011101101
11011111111011101100111010111212111012a222121011120102122221110110110110111011aa11a11110111111111011111111111111111011101111101110101111111111a11111011111111111
11101111111011110111101011111122212221a111121111212011010110011010111111001111aa10a10001111110011110110011111100111010110111111110111111101111a11111101101111101
11111111111111111111001101011010221122a210022220212010122221111101110110101101aa11a11100110101101111111111101011011101111111110010111110111010a11111111101111011
11111111101011110011111111101012222122b211222202221120022111111111100010011101aa10a11111111111111111111110100110111110111011010111111111101101a11111011111111111
10111111110111110111111001110201112122a022212111012220211200011001111111111111aa01a11101111011111111111111111111110111111000111111101011010011a11110111111111111
11111101111110101011101011001022011022a212211012202210211221111110111011101110aa11a11111111110111011101011010011101111111110111110110111011011a11111011111111111
11110111111111101110110111111011210111a220021111211211210111011011111111111010aa11a11010011111111110011111011011111110011111111110111101111111a10101111110111111
01111111011110111100110110100022121202b201212112111211222011111111011111011111aa01a11111111101111111110111111100111101111111100101111110111101a00111111111110111
01111101111111111110111111111201121010b111120212022122102020100111010111111111aa11a10111111110111101111111111111111111010111111111101111111111a11011011111111111
01100011111011011111101101111201101211a011220010121110122011111011111111110111aa11a01111111111111111111001110111011011001111111111111111111101a11111100111111001
11001101011011110101111111011122211212b201021221220012202010011111111111111111aa11a11111111110111111110110111011111111111010010101011111110011a11111100101111110
01001110110010101011111110111100120110b200001121210111202121001101111111111001aa11a11111110111111000110111101111011110111011100001100111111111a10101111111111111
11011010101110110111011111111011222202a221210101221112112111111111111110111001aa10a01111100101111111011100100111111100101110110111110101111111a11111111111111111
11111111111111111011011111111121210110a111202101202121120211111111111111101011aa11a11111111010111111011111100111101101111111111111011111011011a11110111011101101
11011000111111111111111001011101021222a121022221211101002121111111010111111111aa10a11111111111110101111011111010010110100111110111011111101111a11011111111111110
11111010111101111101111011111212210200a122220010110121102111110111111111111110aa11a11111110111101111000011011111101111110111010111111111111111a11111111111101111
11111111101011101111011110111222101002b120111110222220212121011111111000110111aa11a11111101011001110111111111110111111111111101110111111111011a11111110111110110
10111111110010010101111111100000221011b021101201200010012221011110100111111111aa11a01111111110111101101101111111110101111110101111111101100101a10111100111001101
11111101011011111110111111111221121211b210002222122122200011111110001001011111aa11a00111110111010111111111111011011111101111011111001110101111a00101111101100111
11101010101011011101110111111111011001a111111111110110000111111111100110111111aa00a11111111011111111110111111111111111111101011011011111111111a11110111101111110
01111111011111111001110011001111111011a011111111111101011111111111111101111111aa10a11111111101111111111101111111111110101100111111111111111101a11100011100011010
01011100101001101111111111010111111101a111111001011010111111111101110111111111aa01a01110011111111111011110111111101100110101101010111110111101a11110100101100111
10111111111111111111111111111110001001a111101011011001110011111101101111110111aa11a11111110111111011011011101100110101101110111101001111101100a11111110111111111
11110000011010100011100010111111111101a110111101111011110111111011111011111011aa10a10111010111111101111011110011111111111111011011111011111111a11011111011011111
10101111100111111110111001110111111011a111111111101111111101111111111111111111aa10a10101110111111111111111111111111011111110111111010101111111a11101111110111111
11101110010001111111111111101111111101a011111011111111011100111111111101111101aa11a10101111101110110111111110111011111111111110111111011110111a11011011110111110
11100101101110010101011111111111111111a010101111111011111011111111011111101111aa11a11101010011110101110111111111001111111111111111111111111011a11111101111111101
10111110110111111111001111111111111110a111111111111011111001111111111111111111aa01a01110010111111011111111111101111111101101111111111101111111a11010111111111111
11010111001111101111011111011111101111a111111111011111110111110011111011111111aa10a11111101111011110101111110001011101111010111101101111100111a10101111111101111
01111111011011011110011011111111011111a101111110110111011001111111101111101101aa11a10011111111111111011011101111111011101111010011111111111001a11101111111111011
11111101111111011001111011111111111111a111111011110100011001111111011111101111aa11a11111111101011111011111110111111111110111111100010111111001a11100101111111111
11011011111111111111111110011111111011a111111111101111101111111001001101111111aa11a11111111111110011111101110111101011011111111011011111110101a11100101100011111
11111101111110101011111011111001001011a100110111111110110110111111101111111111aa10a11111110111100111110101111101111110011111010101110111111111a11010111111011110
11011011111111111011111111111110111110a111111111011111110110111110011111011110aa11a11101111011111111111111110110101001111011111111111111111101a11111111100111111
