(3,10)
(50,149)
(5,42)
(81,133)
(101,39)
(29,129)
(80,100)
(118,54)
(91,72)
(77,142)
11011111111100110101111111101121000111010020221111011112011a1111101110101101111001111111101110111011110110011101011101110111111110111111111111111111110011111111
01101111111111111111111010111102210021112112210010121222210a0101011111111111111101110111110011011111111111110101111111110111011100011111111111111111111111111011
11111111111100110111100101112111122201021110222222122022211a1101111111111110111011111101111111101110001111110111010111111110010101111111111101101111010111111101
11111011011101111110101111110120021112022202210100112112211a1111101111111011111110110111101111111011011111011111111111110111111110111010011111111111101111111111
001111011111111111110111001122022211102abbababbbbbabbaabbaaa1110111111111111000101011001011111011001111101101101111011101111100011111100110111111010111110010111
110111111110111111111111111202101100221b221001201010221001011111111011110101110101111111111011111111110111111111111111110111001110110011111101111110110111011111
011001111110110011110111011210110211110a201000221212220011111111010110111111011101111011111111001111101011101111011101111011111110110111111111111111111101111110
011111011111111011111111101121120021222b221122210122202211101111011111011111111100111111111111110111111111101101111101101111111110111111110110111111101011111111
110111110110101011101111101212212001112b211220111100122221111100111111110101111000111111111110100111111011111111101101101101000110111010111101110111110111100100
110111111111011111010111111111022222111b112221221202120211111011111110111111011111111111111011110111111111011111111111110101111111101011110111011001111111101110
111111111011111110111111110101121222022a110212122012220001111000111111011011000011111111111111101111011101001111100101111111111111111001011111011111111011111111
110110100100110111110111011010210011211a122221122000220110111011111101111111111111101011010111011110011110111111111111111111011111101110111111111111010110111111
111111011111101111111111111111221001220a111212112112012111111111100111111111111111111011111111011111111111011111111011111111110111010111110011111110101101111111
111101001111111111111111111211022210111b100122120122020021100110111011111111111111111111110011110111111111101001011111111011101111111111001011111011101111111111
011101111100111011111111111001121100222a101210022211111121111101111001110110111111111110011101111111111111111111110101012110202102201102211022121111111001111001
011101011101111100111101110121021211211a201122102111111221011110011110101110101111110111011110111010111111111101112202120221020211212200222010201111101111111110
101111110111101111111111111111121101101a111212122211212210111011011111111111111011111111100111111111011111110011112121022121012010201120120212201111110110011111
100101111111111111100111111110212110221a122202102121122211011100111011011001001111111010101111110111011111110111012022201212112121200211122102121111111111111111
110110110111001111011111111112221211102b201222110112121210111111111101011011111111110110110111101111111111101110101001121121012022222122120201111101111101111111
110111111011111111111101011121100221211a210120212221022211111110100100111111011101100111110011111111111111110111112101211022022101211200212022110111011011111111
101110101111111111111111110111101111011a111010011111110010011011101011101111111111011101111101111111101101101110111102111212112122022222122202110101111111111111
101010111111110111111111111111111011111a111101011111011011110101011110110111110101110111111111011101111111111110112111102121102200221111121111111111110111011110
111101111101111111111111111011110110111a110101111101011010101010111101011011111110111111101011111111111110111110110011210122020220120110112211101011111011111011
110011111101110111111101111111111110111a011101011111111111111101011111111101111110100011111001111111010111011110112222222212212112022121111112111011011101111111
aaaaaaaaaaaaaaaaaaaa1101111111010111111a110100100011111110111111111101011010111000110111001111011111100111111111111110112101222122122111011211221111011010011111
1011011111011111111a0100111111111110111a111111110011111111111111111101011111101011110110110110011111110111111111111210212022122110122200222220020101101110110111
1110011111010111111a1110110101111111111a110111011111110101110011111111101111111110111111111111111111110101110111011102012122121121101211222122011101011101111110
0010101111111110011a0111110110011111111a101111111111101111101110111111111111111111101111111111111101010111101111011211211111211202201121120112210110100110111011
1101100001111111101a0100101011101101111a111111110011111111111111111101111011111011110110111111111111011101111111101221101220111022112212210020120101111111100010
1110010110100011101a1111111111011110110a101111111010111111111111111111111111001111110111111011111111100111101111111012020011020222102020002222120111111100001011
1111111011011111111a1111111010111101111a111110100111111011111110111110111110111101111111110101011111101110111010110221202022110102101020121211111111101110110111
1111111010110111001a1101111110111011111a111110001011010111110111110111111101001011111111111110111011111111111110112221220221112202012122121212121011111111011111
1110111110101110111a1111110110110110011a111111011111111110111111101111111001011100111110111111111100011111110111100010211212121211212220210012111011111111111011
1011111111111111111a1111101111101110111a111100101111100111110011110010111111001111011111111111111111111111101110001210022121101102201201122121101111111110101101
1110111101111111111a1001110111011110111a101011111111001111011111111111111011010111111010011111110101111111000100002011102221101022122121212012101111110111011110
1111001111110011111a1111111111011111111a111111001111111111011110111111011111101110111111111111101111111111101111111222021222010112222201222212101111101111110111
1011001111111111101a1011110110111110111a101111100111111101111101010100011111111011111111111111011111111111111111111112212010100012201001221112111111011101100111
1111110101111111100a1011110111001111011a111111111001111111011111011001011101011101011011111111111110110111111011112222011211100002110112120001121001110111100110
1111110111110010111a1111011110111111111a11110111110111100111aaaaaaaaaaaaaaaaaaaaaaaaaaaaaaaaaaaaaaaaaaaaaaaaaaaaaaaaabbaaaaaabbbbaaaababbabbbbabaaaaaaaaaaaaaaaa
1101111101001111111a0101111111101110011a10101111111111110110a101100111100011111111100111110001010111111111111101111121121222220211122102211212211101111111111111
1111111111111111111a1100111111111110110a11111111100110110111a111011111111101111011111111111100111111111110111111111101020221111222112211121102121111111111111111
1111111111011101110a1100111111111110011a11111111010111101111a111111011011110111111111111111111111111001111111001111111101122121111102101212221220110111011111011
1111111010110101111a0101111111111111101a11111111111110111111a111111111111111011001111111111111101111111011101011112202212010211110011010212111221011111111111111
1010111010111111111a1111111110011111111a11111111111111111111a110111111001011111111111010111111111100101111011011112022111101200110020211211211021111111111111110
1111001011101010111aaaaaaaaaaaaaaaaaaaaa11101101010011111101a011111111001111111101111101011111101110111101101111111111111110101010110101011111110111111110110111
010001101011111011111111110111111111111111111011111010111100a111111111010010111011010101111001111100011111111111110111111111111111110101010010100111111111011111
111111111111011111111001101111111110111111111111110111011111a011100111111111111111111111010000110111111111111011110011111111111100111111111111110011101101111101
111110111111111111111100111111111111010101101111111110110111a111110110111110111111010111111001111101101111111111101110110110111101110101011111111001100111101100
111010111111111111111010011011111111111110101111111010101111a111011111000111111111111111111111111110100111111101111111101011111100101101100111111111100111110111
111111111111111001111111110011111110001110011111111111000111a110010011110101011011110110110111111011111011111111111101111011111111111111111010101111111111111110
110101111101111111111111111101011110111111011111111101110111a011111111111001010011111111101111001011001111111111111001001011111111011111111001101111011110111101
aaaaaaaaaaaaaaaaaaaa1010111111111110110111101110111111110000a111100111111111111111100111110111111111111001110111111111110011111111100111111111111111101111100111
0111101101100111111a1111101111111111110011011111111111011100a011111111110111101011110101111110110111111101110110011011101111001111111111011111111011011111111111
1111011111111101010a1111111110111011111111111111110011110011a111111111111111111111100110011110111111111110110100011111100101110111011110111101111111111011111111
1110111111110111110a1111110111111101111101111111111111111111a111111100101110101111111111011110111111101111111111111001111110110111111101001011111101010111011111
1011111111110111011a0111111011111111111111111101111101111001a110111111111011111111110110111001111111111101111111111111111101011111111111001011011110101110111111
1111011111111010101a1111111101101111110111111111111011101101a110110111111111111110111111111111111111110111111111111011101110111111100101111110111110011111111111
1111111111011011110a1111111111111111111111111011111111011011a001010111111111111101111011110111110011111011111111111111101111110101111011010111101111100011111111
0101100110111011111a0011111111111111001111111111111011110111a111011111111111110111111111111011111111011011011011111110111011011111111110111110111101111001101111
1110101101110111010a1111011111111111111111110111111111110001a101111011111111010010001111010011101111101111111111111111111101111111011111011111111110111101100011
1111100101111110111a1111110111011110111011111111111111011111a11111111111111111111011111011111011101111111aaaaaaaaaaaaaaaaaaaaaaaaaaaaaaaaaaaaaaaaaaaaaaaaaaaaaaa
1000111101110110101a1010111111111011101011111100111110111111a11111101011101111110111111110111011110011011a111111111111111111111101101111111101101001011110101111
1110111111111110111a1101111011110111110101000111011111110111a11011110011010011111110001111110011111011111a101111001011101011111112211211012221122222120222221111
1111111111101011111a0111011111111110111110111001001111110001a11111111111110101011000011111111111101101011a011111111110110110110221212102122122201212220201121111
1111111111010101111a1111011110110111110001111111111001111111a11110110111111111111100101011111111111111100a111001111111010011111220102201112122020222022121212011
1111111111111111111a1011001111111011111111111111111101011101a11011111111011111111010122211212211202102121b010200110110111111010211212102202120212222011211222111
1111111111111111111a1111110011111101111111011111110110110101a11111101111111111011110002212222201000101011b100001000011211022111222202222222212212222121022221101
0101001100110111100a1001111011011011110111111110111111101101a11111111001111111011110111122121201201211111b001011122101122222022212112202222012222222122022122101
1111101111101111111a1110111101101111110100111111011110111011a11011111110111111011111110212222021022101211a101212121011110022112222202022202110222212220202111110
1111011011111111010a1011110111110101111111111111111111001111a10110111011110010011111020112112210101121110b021201202110101022221210112220012202222012211221021011
1110101111111101111a1111111111101111110101011111011111111111a01111011111100111111111111221021110221220111a221111102101120111221202202222221221211222210102012111
1110110111001110111aaaaaaaaaaaaaaaaaaaaaaaaaaaaaaaaaaaaaaaaaa11111111011111110111111021212222212011111122a111222220101112020121222222022121102201001121022110111
01111111111101101011111110011111011010111111111111101011111aa11111110111111100111111012122212122122122011b222122221111112110121021211120021210212010011102112111
11111011111111111110110101011011010101110011111111110111110aa11111111111011111111111010211111002202211202b101121120111112222012112222222122220222121122211012110
11010011111111111111111011111101111111111010111100011111110aa10111111011111011111011121010222201211012111a001121221011012121122222002220222022222222021101220111
11111001101111101111111111111111111111101111101111111111111aa11110110111100111111011112112102202220222222a000121121011101222121002102222221212222222201212220111
10111110111111110111011011011011111111101111101111111110122ab10212202212002211210012122221111121221111121b212221021001221112210221222121021122222202000211211111
11111111110110111001111101111111011110011111111111011111122ba22121012100212112012122010211012022022022221b112002012011211200112202202222212111102122101201110101
11111111001011111110011111111011001101101001111111111001122bb10111222122112220111221112120220122122222122a202211201111200022222212202212102112222201112102201101
11111011111111111100111111001111111011111111111110111111101bb12211212121120201020112022011202210212021010a200220112111212222110020222212222002220020221201100111
11011011111110011110111101011101100111110111011111111101110bb21100122221002101201112222101201012122111210a122222112111021122012202212212100222222202022020201011
11011101011111111010101111111110001110111111111110111111102ba12111211112211211101111122222111221021102212a001122021111122102010120201022112212121222222122120011
01111111111011111111110011111111111111111110101111111110120bb10012102220211002201202120202122012121101112b122120100111010212211211222221212220122122221011120111
10101101011101111111111111111110101101111011010111111101121ab12211210212200111111121212001211211201012211a200111122111011012221020201202222012202222022002122101
11111011111111101111111100100011111111101111111111111100002ba21220122011120101202122121121211221021122212a222201220111012110122012222012222222201222211211221111
11111111101111011111011111111101111011111001101111001110101aa20212111111121110211211202121121112222111122b222021210101102121212212022222201220021202112212210111
11111101100111111111111022220021110212111212111112120210111ab02001121121121212200121122221112111001220221b112102122101212102210122121222222222122121121202201101
10111101101101011110101121111222121111100122202122021211121bb01121010012210112211210022112011012121011201b112001020111002111101222020110020022100221111112101111
00111111101111110111100122110112121222021220112122202101121bb01220112022120122112021120020101200122221211b212122122111221220222122222022112222110022002111112111
11111111111111101110110121220110210221100121220021120201101bb01221111212222220022221120112101212112020111a220111010111121222220220122220222122112220212111122111
10111110010110110111111121221111112202222222122221221211102ab22221021100012120222122222120121212211002211a211220111111211001111121110201112211102222122112101110
11111110111011110111111121111202212122222202111101212111111aa10120222221221022122222122111110021221112210b212100122001221122121202222020200202222222121102200010
00101111011100111111111121112111121220121202210221010011122ab12012222121102202122222222222021002101001212a121122102111222222122220202220120201210000111001001101
11101111111111111011110111011022121212022021212222221211122ab02202020110222012211122212112201222212221122b001112101101121100220202222121220222210221100111011101
11111100111100111011111112211121122011112120222220211001001aa21112221211211121012222220010022111112101221b122212102111112222102211001222010221110110111111111011
11111110111111001010111122222211222122101222222112111101022ba12212202121021010220121222111110101111111100a111000101111110102212112020201122122010022111111110111
10101111111111110111110011212111022221112112200221111011100ab00112111221201220202221201111000111111111111a111010111111111111110111010111111111111111011011111110
11011011110111110111100111222112222212120222212011222111121aa10112220112122112212110121011110110111111101a101001111111010111111111001111100100101111101110111111
11111111100101111111111112220200111011211212220221112211012aa21110222220211211101211121110111111111011110a111111110111101111110110111111110111110110101101101010
01111111111100011111110111111111120201010011121112001210121ba22211101120112221212222022111101011011110111a111111111111101011111101101111111110111101010011010110
11101111011011111101111112110210021012221222220201021010012ba12222222200120221102002202011110110111110110a111011111101110111011111110111110111111100111111111101
11111111101111011011111111122012202222001212200212122201120ba12112021020221221212121122011111101101110111a111011101011111111101010111010110011111101011111101110
01111111111111111010111122120110120020121222101221210211122aa12112000101112222121022210101101011111110011a110110111111110001110111110111001011111011111111111111
11111011111011111111101102112112222120122220210222122212221bb22122220011212001222112022010111101111111111a111011111111111111011111011101111011111011110111011111
10111001111001101110111122222221022212022220212221022022112bb12011222120011120211222002010100111111111111a101110111111110111111111111101100101111111101111111101
01010111101111111111101121211120111022102212022222120012112ab20212122011102222122211011110110101111111010a001110111101110111011101110101111011111111110011111111
11011111111111111111101121122221112222221012222011221021220ba02021222111101111111101011111110111101111111a111111000100101110101101001011111111111101011111111111
01111111101111101111111012222110111212222002222012222211111bb22222022111111111101111101111111111110011111a011111111111111110111111110010011111100111110101001111
11011111111101111111111120122022111022222200212202222212120ba11211010011111111110111111100001111111100001a110011110111001111111011011111111110111111111111100010
10111111101111011111101121120111211111212022202221022012021aa22121002111111100101111110111110111101101111a111111111111111111111101111001111111101111111101110101
00111111101110111101111120012110222110222222220122202220022bb10011122110111111111111011110111111111111111a101011111111001011110101111111110111010111011110111101
11000011111001111111011112211111111001102221100021102222211bb00101112111111111111110101110111111111100100a111111111011111111111101111001111111111111011111111111
01011110110111101111011111202121111211022222002201221212210ba11011221111101111110111101111101110111110110a110110111111111111111111111011111111111111111011111110
01101111011111101110011112112212122111212220222222002022220ba20222111111011011111111111011111011110110111a110111011111111111101111101111111100101011111111111110
01011111011111110111001111222120222222121200210002222221202ab00220010111111111111110111111101101010111111a101110111111111110111111011111011111111111111111110110
11111111111110110111011122001212111112122222221212211112022ab11111201101111111010101111111110101111110111a101110111111010111011110100101110111111011101111110111
11110010111011111111110111111111111111102021002121101220001ba11122011111110111111111111110111101111110011a110111111110010101111111101111011101111110111011111111
11111010111111111111111101011110101101112201022000222211222aa11022111111111111110011101110111111111111100a011111111011011100110111001001111111110111101011111101
11100111111101111111101101010111111101100220022120111121121ab12120221111111011110111111111111111110111111a011101111111111111110111100101111110010111110101011111
11110011110111111011011111111111111110121011111220112022122bb22112212111111001111101111011111111011111110a011111111111101101101111111111011101101111111100111111
