(108,9)
(15,122)
(39,123)
(87,19)
(12,26)
(54,1)
(67,156)
(4,59)
(97,123)
(45,157)
101111100110222212211101020211112211102221111102221222211211002212120222201110010101a110111110111011101111111011111111111111a11101101111111111011111011001111101
101101111111020100112111022122112100110000112222100210110212200101121112121101011111a010111110100111111111111111111010011111a11111101111111011011011110011110110
111111110101021012202000121211101222112210010101211222210221111210100112211011101111a111111111110011101111011111111101111111a11111101111111111111011000011111111
111111111002102211222012002022122211201221111222110210101212221221222020101111111111a011011101101101111100111011111111111110a11011101110110111011011011111100101
111111111112210212002210120011120221210221111222102111222020202120121021211101101101a001111101111111111111011111110110010011a11111111111111111111110011011011101
111111111102010202200221201222012100110121102101112122021211201122012122111111111011a111100111010111101101011111111111111010a11011100111111111011111100001110111
110111111112112220122212022002212112121020111201021102112120122022101200120111011111a111101111111111101111111110111101111110a11101011111111010100111110111111011
111111101111210022122212121111111122111210101022211120220100102202211222011111111111a111111110111011111111111101110111110101a11111110101011111001100101111111111
aaaaaaaaaaaabbbbaabaaabaabbbaababbababaaaaaaaabaabbababaabaa102122201012210111001111a111100011100111111011011111111111001111a01110001011101111111011111111111111
11110111010111202201012012211111211202212111021112011021111a120021112211211111101111a111111111111111111011111110011111101110a11011101111111111111010110111110111
01111110100121122222121121202021220122221001002122110211122b122022121012121111011110a111111111111101001101111011110111101111a11111101111011111111011101011111011
01110111010100101112001021112200101222022110222221112111212a022101012120001101111110a111111101011111111110111110011111101011a11110111111011111011111111111101111
11111011111212122222201022211020011112220110211222010122212a212110012011101111101010a110111011110111111111111111111111111111a11111100111111101111111111111110110
11101101111102122112222210211001211121112101211222212210220b112022110112221111111111a011011110110011111111101101111111011011a11101111111111101010110110111101111
11111001111201221001222222220202202100211111221122001102021a201221111220111111111111a111111111110111111011110111111111110110a11111110101100101110101010110111111
00101111111222122111112122212000101222112111000022221012022b021211120021221101111111a111101111111111010111111111101111111111a11110010111101111110101110011010101
11011111100121120220122221121121220210102111212211110120120b221221121122221111111111a100001111111011111011001111110011110111a11010101110001111110111011110111111
11111111100211102121220211220120002210211011111210112212201b102211212221001011001111a101111101110111111111010011101111101111a11010101111111111100011111111111111
10111111011101100202012122111201211112011011011222121212211b102110012112201111010111a101111011110101111110111111011111011110a11110111111100111110101011001111110
11111111111011222021010111122221000112112011100111111111111a101111111111111100111101a1100010111111010011aaaaaaaaaaaaaaaaaaaaa00101100101111010001111111111111111
11001011111212221112012022221222210111112110111011111111111a111111111110110111011111a1111111101111111101a1110101111111110011111010111111111111111110101111001101
11111111111211101121122101221101112022122111111111111111010a111111111110111010111110a0110111111111111111a1111111110011101111111111110111111111111110111111111111
10111011110121211110112211112120111222211111000111110001101a111111011101111110110111a1101100111111111111a1101111011111001111010011111111101101111110011111111111
11111110111221202120112201001101222011110111110111110111111a111101111110111010011111a1101111111101110101a1101111111111110010111111101111111111111111111111001111
11011111111222111021201201201020010002020111111111110110011a111011111111111111111011a1111101111111111110a0112211022112021212002211122221211111101111011111101111
10010110111222201111200202101112121112111111111111110111110a111111001111111110111111a0111100111111111001a1112120110121000002210201002110110111111110111111011101
11111101111111220122122211000220201122120111101111111111101a101011111011111110011111a1111111011111011110a1101212111212222111212212110100021011110111001011111111
01101101111110111111110110111111101111110010111111111111101a111111111111111111111111a1110111110111111111a1102211121100220020022111011111111001111111111111111111
11111111111111011111110110111011010111111111011101111111110a100111011101011110110110a1011010111011001101a1112111221202201111111002120211220111111111111011101111
11111111111110111101111011111111111111111011111101101010110a111111110111111010011111a0111110111011011100a0112220121202111122022212220012021010010110011111011110
11111110111111111110111110010111110110001001111111111111100a111110111111111111111001a1111110111110011011a1112111111121120212121211112120121101201102020112212121
11111101111111111111100101111111111111111011111110111111111a101101111111111111110111a1111011110101111111a1111101201211221002202022211200111001222211102221012221
11011111111111111011101110111011110011101111001110111111111a111111011101001110111101a1100101111011011111a1111010212120021222012011221221211011110222221122022022
11101100111111110011111111111111101110110110110110111011001a111101111111000101110011a1111111111011110111a1111210112120212201122002221112011111222110201221211112
11111110011110011111010111111101011101111111101110111101111a111111011101111011111110a1101110111101111111a0112212110021212221101220122012121111121111222210102102
11110011110101011101010111110111011011111001111111011101000a111111111111111111111111a0011101111101100111a0011220201122202111220210200120210111110102110222111111
11001101111111111011111011111110111111111111111111111111011a110111111110001111001100a1111111111011111011a1112221011202202022012110011010001110210101111220121222
11111111011111111110111111111010011110110011111111110111111a101111111111111111111011a1111111101111111111a1110222101102012102022222101202111111211111212012221010
10111011111010111111111100111111101101111011111111011111111a111011111001101101111111a1111111101111111111a1111222121211101220021120202122101111122201121011211212
10220120110111221111110101110101111011011111110110110111110a111110101111111110110111a1111101111011111101a1111100120112110010201212222010101111122121122101210010
21222122112112220101011101111110011011110111011111111011101a100111101011110111111100a1001111111111111110a1110220200202120101121111210112110011101022100111211212
20021110012222110111111111111111011110111111111111111111101a101111110111111011111111a1111111111111111111a1101201220110220120002110222120021101212020021102021210
12101220220212121111101111011111111101001110111111010110111a111101111111111111111001a1011111111111001101a1111100002111220222220222122212211100121122121211210110
22211022222222121101110111101111111111111111100111111010001a011111011011101111111101a1110110111110111110a1011221212221212102122102021211220011122201201111001011
12012200222011121111111111111011111111110011110101111111110a110111111101111110111111a1111111111111010111a1112122120222112212121222022202001111011011122202222221
20211212102211111110111101111110010111101111111110111110011a001110111110101101111111a1101010111111111100a1102221211002122011102002002122110111102112102110211112
12011221211201211111111111111101010111111111111111011111111a010110100111111101110111a1111101111011110111a1011122110111202122120012100011111110222111112211221102
21111121201121121011111010111111111111001111111010010111111a001101111101111111111011a1101010111111111011a1111222121022112212221111220120110101122122210201110122
12112121200201211011111110111110111111100111101111110101111a111111011110111101101011a0111111110111111110a1011121222112211102220211211221101110021111210112122112
01221201001210111101111001110011101111011111111111100110111a111111111001111001111110a1111111110111111111a1002001210221111221222111110220211111111001220221221210
21110112121220211111111101101111111111111011110111110110111a111010011110111111111111a0111111011111111111a1011122110122102201220201000100101111022221212002212212
20012112221222221111110101101111111111111111110101111001110a011111111110001011011101a1111111110011110111a1111022221112111020211202101111011111201102111210002212
02022202222122111111101111111011010111111011111011111110001a001111111111011111000100a1101111011011101111a1110221111110021111221221222111111112212121221221012002
10121222212122120111111010111111101101110111111011101111111a111111011011111100101111a1110010011001111111a1111101221021211011120211022102111111212202212121102212
01112221100120211111111111111110011111101111111010111010011a111110111110100111110101a0101111111111111111a1111101111111101111110111111111111110212222221220221122
20122202112011211011011011111011110111011111010011101111111a100101001111111001111001a1110111011110111111a1110111111111111111101100111111111100222222220222222222
11202220122202121111111111011111111111000110111111111111111a110111111111111001100111a1111101111111011101a1011111100100111111111101011101111010012220221222222102
20211120221020110111111111011101110111111110110111011110111a111011100111101011111011a1101011011101111101a1111011111111110111001111101010111111222021210212022222
21022002212120001011011111111111111111111110101100111101111a011111111101111111001111a1011010111111111110a0111110110110111111111101101111111112212222210122212210
20020121112221211110010101011111111111111111111011111101111a011111101010111111001111a1110111011010111111aaaaaaaaaaaaaaaaaaaaa11110111011111011222200020201212120
12110201220221020111011010101111111101111111101111111111110a001101111111111111111011a101101111101111111111111101011001111111a11111101111111101211010121001120200
20121220211221101111111111101111011111111011101011011110101a111111011111100101111111a101111001011111111111111101111011111111a11111110111111112101202212022120002
11211112211222110101111011111111111111111111101111111111100a111111111111110010111111a111110011111111101110111111111111111011a11111101110111111211110001011212022
20020001212121221110111011111111111111111111011010101111111a111111111111110101111111a011111111111110111111111101111111111010a11111111111111010121222121220221111
21110011110211210011011111111111110011111111111111111101111a011111010111111110101111a111111111110110111111111011110011111001a11111011111110110122201221112211212
11211111002022210111111100110111111111111111111111111111101a110110111111011111110110a111110111011110110110101100011001111111a01001111101011100210120111222122220
01222121202021210011110111011001110110111111111001111111010a111010111110111101101100a111111010110111111111111111011110101101a11111011111101112212110221222222112
22111011022102110111111011111101111111111111111111111011111a101111110111111111111011a011011110101010010111110111110111111111a11111111110011001212202121001102122
aaababaabaabbbaaaaaaaaaaaaaaaaaaaaaaaaaaaaaaaaaaaaaaaaaaaaaa011101111111011101110111a111101000111101111101110011111111101111a11111111100111011211212122012112222
011001011101101111111111111011101111101111111101111111111110111111111011111111111001a111011111111111111111011001111111101011a10111010101011012212021222101020121
111111111111010111111101011010101111111011110001011110011110101111111111011101110111a101111011111011100111110111111111111111a11111111111111111210222112111221020
111111101110111011100111100011000111100011001111110111110111011111010110111111111111a111111111111101010111111010100110011111a01110011111100102120100102212201011
111021112100211122221222002212212211111111111111001111111111111111111101111101011111a100111111111001110111101111111011011111a11111000111100110102110220121212001
111121221112120122010221121201222111111111111111111111111111111111011101111101111011a111111011110111011110111100111111111011a11111111100111110111121022122011220
111111202110100122022211012002212211001111101101111111001011001111111101111111111110a111011111011111101011111110101111111101a01111010011100111200221222101020100
111020100120211112200112111212201211110001111110011111101111111111110001011111001011a111111111111111101111111111111110110101a11111001111111101212101112212221212
111111221122210212111120012001211211011011011011100101111111111111011111110111111011a111111110011011111111110111110101111111a11111111110011111110021001212210111
111110120121110111102210122221220111111111111111001111111111111110111111111111100111a101111100111001111001011111100011111110a11100111111111111222221211222021021
111112122220022121022111222122112211101111110101011111011111011011111111101111111111a010110111101111111011101111110111111011a10110111111101111212222111220112102
101011221012222201222222212121200201110101111101010111110110110011011101111101110001aaaaaaaaaaaaaaaaaaaaaaaaaaaaaaaaaaaaaaaaa11111101011101101021201111202110222
1111111212220210221111201122222222001111101110111111011011111111101111011011101011111101101011110010111101110111101111110111110111111111111010211000121112120222
1111012111112212221210221222221001111111101111111111111111111111000111111111111110011101111011111110111101111111110111110111111111110011010112102211112211211000
1011220102121122121102202120011222101101111100100111111111011111110111011011100110111001011111011111011111111222002112212022021000101101121111111110111110100111
0111101101011102021babbbbbabaababbaaaaaaaaaaaaaaaaaaaaaaaaaaaaaaaaaaaaaaaaaaaaaaaaaaaaaaaaaaaaaaaaaaaaaaaaaabbabbbaabbabbbabaaabaaaabbbaaaaaaaaaaaaaaaaaaaaaaaaa
1111112212112221201a20020112211021111110111101111111101111111111011111011001111111100111111111111101011101112022211011111122021111121211000110101111111101111011
1111112220220111120a22222011111210111111111101111111111111010101011011111110110001111111110011110111011011112102221210222221220112222201101101101111111111110011
1001021101012202212a11221020200211011111111111111101111011110111111111111111111111111111111011101110111111111020120201221102121202101112221111111110111111101010
0010121110020122101a02122011202002011011001100111011011101110111111011011001111011101110001011111111111101110122111100100212120112212102121111111111111101010001
1110212101222122111b12222221022101110011011011101110100110110111101011111011110110111011111011011111011011112210221110102212202210020002121110111010100111110110
1101200011121212221b11020221100211110111111100011111111111000111011111111111111101110111111000110001111101012011002010121222012111221122111100100110001110111111
0111211201202101022a12222102121210110110111110111111110111111101111111111110111011101101001011111111111111111200111221122111101001212222110100111111111111111111
1111112222121110112a22201102111001111011111101101011111111111110111111111101111111101111111111011100111111111112121211100112222212221021221011111111111101111111
1111211211220210111b20002020121100101001111110111111111100111111111110111110110111111110111111111110111011111010122212111102111120222211121111111111111111111101
1111112101002021101b22010110012222111111111111111011110110111111001011011111111101101111101011111111101011102200212002200212210112221112101110111111111101111011
1111202211112210010b12200122222111011111011101001111111111111111101111111111111110101110101111111111111110110111112022101011202221211111211111110111111101111111
1111121202212102101b20222101222210110111110111101111100111111111111111111110111001101111110111110110110111101222210202221111122221012012211111111111011110101011
0111212121122010021b20221121200021010110111001111110101111101101111011101111111011110111001111101111101011111110202211221122120011222201120111111011110111111011
1001222111122222112b02102121212221111111010101101101111111011101111110011111011111111110110011110001111111112022122222122011112101010201111111110110110101111101
1111002102102101212aabababbbbababaaaaaaaaaaaaaaaaaaaaaaaaaaaa1111011110101111101011101001110101111101111011122212212202210222021201201021200aaaaaaaaaaaaaaaaaaaa
1011211222212120110ba110212221221111111111111111100011010111a1101110100101111111011100011111111111100011001112200111212021201210211022211211a1100111111111111111
0101212222221111211aa021112102112210101101111100111111111111a0101011111100111111111011111111111111111111111112012010222122222111101012110101a1101101100111111111
1111022021122200111bb200221121122011010111111111111110110111a1111101010111011100110011110110110011111111111120120111011221120022122211112100a0001101111110111011
1111111111111101111aa111101111011111111111110011111110111101a1111011011110011111100100011111111011111111111120222111212122211221022120101210a1110111111111111111
aaaaaaaaaaaaaaaaaaaaa110110111111110110100011111111111111101a1111111111110111111111011111111111111011111011122211021011020221011211111111011a1111111111011111111
11110101011111111111a010101111110011111111011111111111111101a1111110101011111111111001011111111110111111111021102122101222021212012210101111a0111101111110111011
01111011111110111111a111111111110011110111111111101110111100a1111111111011101101111111111111111111110110111020201212121221221000211221120210a0111111111111111110
11100010111111111110a111111111110001111111111111101111111111a0111111011111011111100011111111111111101111101111212111221022211220111012221211a1111111111100111111
11111101111111101111a010110111111111111111111110011011111111a0111011111111101111111001101111010111101100110122121210212122120211101122222211a1111110101001111111
11111011111000011110a110110110111111111110111110111101111111a1011110110011111011011011111101011011111111111022211101221200122010112221120211a1111110111111101111
11101101111111111101a111101011101011011111111110111010110101a1111111111110111101111011101111010110111111111122011122211111221122122210021211a1110111111111001111
01111111011110111111a001110111111111011111101011111101101111a0100011101111111011111011100111011110111111000100210121211010212012220211111111a1111011111111011101
11111110111111111110a101111111111111110111111111010111110111a1101011111101111111111011111111111111001111011021020201011221002122020112112110a1111111111111111010
11111111011111111110a111011010101111111111111111111010110111a1111111101111111001101111001011111111111111110111111110101010111101101111111101a1111100011110111011
11111111111101110111a111111001111101011111111110111110011110a1101101101101111111111001111111111110011110111111111011111111011110110101111111a1111110111110011110
11101110111111111011a111101111111101111101111111101111101101a0111111011111110111111111101111111111110110111011111111110111101111111111110110a0111111111111110111
11111101011111111111a111111111111011101011111111111111111000a1111111011111111111110111111010111101101111101011111111101111101011101110111111a1101111110011110111
11111110111111100111a111111111110111011001111111111111111111a0111110111111110111111010111101111111111111111111111111111101111110111101101101a1111100110011111111
01101011111111111101a111111011011111011111111111111111100011a1111111011111111111110111110011011110101111010111111111100011100110111111111111a1111010110111111111
11111110001100111110a011111111101111111111111100110111011111aaaaaaaaaaaaaaaaaaaaaaaaaaaaaaaaaaaaaaaaaaaaaaaaaaaaaaaaaaaaaaaaaaaaaaaaaaaaaaaaa1011101111111111110
11111111111111111110a0111101111011111100111111111111111101111111101101111011101110111111111111111101101111111111110011101111111111010111101111110111101001100111
