(97,144)(104,25)(6,67)(118,90)(107,128)(40,8)(83,14)(14,11)(6,15)(15,141)
(1,61)(10,69)(107,12)(0,154)(2,99)(111,112)(2,148)(118,119)(119,153)(104,40)
(36,10)
(2,70)
(78,115)
(98,1)
(52,40)
(118,67)
(118,16)
(51,119)
1a111111111110111a11110111a1111100111111111110111111111011202222012221001202221101120101011111011011100111111110111111011011111110011110110111111111111111100111
1a111111111101101a11111100a0101111111111101111100101100110211201121202121010112112012111111111101111111100111011110111010111111111011111111111111111111111011101
1a111111111001111a10110111a0101111111011111110110111111222121210221012012221112120220110101111101111111011011111001101111101111110111010111111111010110011100111
0a111111000111111a10111011a1111111001111111101010111101120221222112222021111221120001101101111111101011111101011000111111111111010111111111111011111011111111111
1a111111111101111a11111010a1111110010111111011111001101210121122221102012211121001121101111010011111001101101111011111111011001110101101111111111111100111111111
1a110111111111111a01110111a1111011111111111111110011111012102121120222002102122100201101111111011101010001111111111111101110111011011111110110111111110011111101
1a111010001111111a01001110a0111111101011111111111111111122211121222101110011110111221101110111111111110101001111110101110111111111110111111110111111011111111101
0a111111101101110a10100111a1111101111111111011111101110021220121021222201111122210111101101111111111101101111111111101111011101110111111111101110111111110111111
1a111110111111111a11111111a1110010111111110111110110111211111110010111011020211122211001111101101111101011111111111111111111000111110011111111111111110111101001
1a111111000111111a11101111a1010111011111101111101111011121221112201222202011220121102111111110111111111111110111110111010110111111111101110110000111111111001111
0a111111101101111a11111111a1101111110111111111111010110101122022211221200221121120211111111111011011101101110111111111111111111111110110111111111011111110111111
1a111110110011111a11011100a1111111001111111101111111111212122000011202012111220221221111111111110111110110111111000111011111110111110110111111111111011111111111
1a111111111111111a01111111a0111111111010011111111111111212220110102202011112021022112011111110111111aaaaaaaaaaaaaaaaaaaaaaaaaaaaaaaaaaaaaaaaa1010110010111100101
1a101011111001011a10001111a1011110011111111100111011111212122212221211101110120111211011011111110001a111101011111011111101011111100011110011a1110110111111111100
1a111111111110011a10011111a0111001111111111111111111001222202011101110010122211211112111101111110111a111111101101101110111011110111111111101a1111111101110111011
1a111011110111111a11111001a1101101011101101110111111111122122220221121222211210202210110110111111001a110111011111111100111111111111111111111a1111111001110011111
1a111100111111011a11100011a1111101100110111110011011111221201200212211201201121112001011111101111101a111011111110011100011110011111101010110a1111111111111111111
1a011100101111111a11111111a1111111111011111101111010101111111111011110101001111101011010111111111000a110101110111101011111111111011111111111a1111111111101111011
1a110111101111111a10000001a1011111111110111111101101101100111101111001111111111111011111111101111111a111011101111111010111101111111111011101a0111111111111111011
1a110110111111100a11111111a1110111101011101100111101111111111111111111111110111111101111110111000111a110111111111011001111111111001111111111a1110111111111101010
1a011111110111101a11111010a1111110101111011111111111111111111110111101111101111010111111111111011111a111101111100111111001110011101101111111a1100111011110111111
0a220011022201201b21211021a1111111101111111111111110111111111100111111001110111110110111110011011111a110111111110111111111111111111111111111a1101111111111111111
1b021102111100112a11210221a1111111111011111011001110011010101111111111110111001111101110111100011101a111101111111111111111011111111111101111a1101010111111101111
1a112121222022212a02102121a1111111111100111001111111100111110011011111111011111100101101101001111101a010111110111111110011111111111111111111a1110111101101111111
1b112111011111112a22021221a1101011111101011111111111111010111011111011011111111111111100110110111011a111110111111010011111111110001111101111a1101111111111111111
1a221212110221122b21222121a0011111011111101110111010011111111111101101111110111011111111101011101111a110111110001111111111101111001111111111a1101111101101011011
1a222120101102011a20211211a1101101110110111111110111101111111011110111111111011110101010111111111111a001111101010110111110111010111011111101a1111100011111111111
2a201211111211212b12212201a1011011111111011101011110101011001111101110111111111010101101111111111001a111111111001111001110001011100111111111a1010111110111111111
1a202212111021121a12111201a1101011111100111110001011001111011011111111111001111111011011010111111011a111110111100111111111011111111111111101a1011011111011111111
2b020022102022201b11221120a1101110111110111111011111010111111011111101110111111111110111011011001011a111111111110111101110111111110110110111a1100111011111011011
0b222011202102202b22101011a1011111111101100111111100111110011111111111111111110111101111011111111101a110011110111010101111111111111101110010a1111111111111110111
1b211020122111112a20021211a1011100111011111111011011101111001111111001111111111110110111101101101011a111011101111000111111111110011111001111a1111111111011011101
2a220021111202212a12211121a1111111100011011111111111010100110111100111111100010111101111111101111011a111110111011011011110111110001110111011aaaaaaaaaaaaaaaaaaaa
2b101012112112102b12011221a1100110111110111111110111111111111010011110111111111111111001111111111101a11101111111110111101111111111111111101111101111111011111111
1a111020220112111b20111221a1011111011111011111100110000111111101011001111111011101101111111011011001a11111011111111100111111111011011011111110101010111111011111
0b020220211012111a10211211a0111001011111101111101101110101110111111111100111101001111111101101111111a11111100111110111111101111101111110111100111011111011110111
2a220211111121121a11122121a1100011111111101110111110111111111110111111110010011011011111111111111101a01002112010010121000012112022112001011101011111111111111111
2b120200202221121a12211100b1211102211112221102122012222101101110111110110110111101111011111111110010a11121200211222011211002101112221211100100111111000011111101
2a222002211211212a10221200b2211121002120010112222212222010111111111011111111111111011111101111110101a00121112222111011122111111012222111111111111111111010111111
0a122021112221110a02210211a2122120110111212211221210212111111101111111111011100111111101111101111111a11001011111101221012011110211111111110111110111111111011011
2b112002221011120a10110111bbaaaabbbabababbbbbabbbbbbaaaaaaaaaaaaaaa110111110101011110001111101111111a11101022221200122022122122000102211001111111111101111111101
2a211211222121010a012111222122211212210122122201211120211111101111a110111111011100011101011011010101a11110221120122212101212211111222211010100101011111011110111
0a120112210021222b210211111212011100110212111221110211211011111111a111011101101100010111001101011111a10121101021000212211121120111212211011111111111100011111100
2b111222110121220b121202212111120112020211201001212210211001111101a001111011111111111110110111010110a11111220120022102211111020201000101110111111101111111011111
2a222212002212200b222111222112010120112122200221220202211111111111a011111000111111111110110011111111a11102122022111010202212202110221010100101101111111111100111
2b222211110112122b221121211012212122121221022112212012211111101111a100011111101111111111111011111011a10120202211101221110021112220122201011110111100111011110111
2a211101222110220b121112222112121022111222022111211022011111011111a101111011111111111100111100110111a11122011122001022202222202212202211110111111011101111111011
2b010222100221221b121201211122222012202202112020211210210101111111a011110110111111110011111110101110a11122201221222111112210120222110101101111101111111111101111
2b111221211212222b122001122101111121110112200222011202110101100111a111011011111111010101101011101111a11121112120202110220112122211112201110111011011111101001111
1b222111112201221a201212220212211222221222121100121201211101111111a001111100111111110111111111111101a11101011212122121120122220112221111110101111101011111111111
1a102112021222010b201211220111112202221212211202212121211111101111a111111110111110111111101111101000a11120021211201221122200112222112111100110110111111011111111
1a011110011100111a111111122212221121121211112212212010000111111110a111111011111101111111011110111101a11121112111111111112121212012210011111110001101110111101111
1a101100001011111a011111121020222000212110012021222122011111111101a111111111001101101011111111101011a11022120210201120212110011112222101110110111010110101111111
1a011111101111000a111100112111022000212121122111111011211011011100a111101111110110001101111101001111a00010202222201221221211112100101111111111111111110111111001
1a111111011111111a111111121112202012201222211111211201111111110011a111111111111101111101111101110110a01122112022112201121121122212222110101111111111111111000111
1a111101111111111a111111122220121221102121202011021121011011111011a101010111111111111111100101111111a01121012211220110221212121200212111111110011101111111111111
1a111001011111111a011110121112221121111221012221011212211111101011a111110111111010111111111111111110a11011101022122110111012212111021011111111011111110111111111
1a111111111110111a111110102110020021222222121212120111110111111111a101100111110111111111111111111111a11021012110122200012022221112211011111110011110011111111110
1a111111111111111a010111111012111222111111212021010210211111101111a111110010111111110101111011111111a01122000211101121222221121012221210111111101011100101011101
0a110111101001100a111111110111111220201221101012120120111111101111a110111111111111111111111111111111a10111220202201002221202101120222210011111111011110111110011
1a111111101001011a111101120102100010122000211122201221111011111101a011111101111111111101011001111110a11112021012020201022212122111112011111010111011011111111001
1a111011111011111a111111112212022111112122200211222220211011011011a101011011111111111001011111101111a11121021120222222121121101010212011111101101111111111101111
1a101111111111110a110011120210220122122110102121111211101111111111a110111111111111110111111111111111a01101212101112210012202121212102111110111111011111111110111
1a111111101111010a111111121211102122011022121002010121211110111101a111001011011111111011111101011010b11022212222112220222220202202101111100111110111001011111111
1a111110011111100a010001112210001220020122122222221220211011111110a111101111100111110111011111101111a10220002212020012210102000021211201111101110111111111110111
1a111111111101011a010111022111101122121022021021122221201011111111a111101100110011111011111100111100b11122212212122122120112222200101211111111011011011111110111
0a101111111110111a111110112211101122022212221212222102211111110101a110011111011101111100001111111011a11221221111202111012100201112111111111110011111011101111111
1a111111110001110a111111111110000111101111101111101101111111100000a111000001111100111101011110111111a02101101110212211112201021222111111110111111101011111011111
1a001010111100111a111110101001111111111111011111111111111011110111a111111111111011111111011111111101b11011000211012212111210111200111011011011011110101101001111
1a111111100111010a010111111001111111110111111111111111111111111010a111111111111011111100111011111111a12021121110101111111221212112101111011101111111111101110110
1a111111111100111a110111111011111011011111111111101111111101100111a111111111111011011011011110101011a12122222022112212210122121020111111111111111111111111010111
1a101101111101101a111100111111001011111111111111011011110101011111a110111111101110111101111111101111a10121111002010211211020211222011111101001111110110111111111
0a111101011111101a111011011101111111111111111110111111111101110110a111111011111010011110110111111111abaabbababbbbbbababbabbaaaabbbaaaaaaaaaaaaaaaaaaaaaaaaaaaaaa
1a111011111111111a101111101110111111101110011100111011011111011101a001110011111111101111111111111111122120221211210221121120222222111101101111110111111010111111
1a001100111111111a111101111111101011011101111011011111110110011111a010111110111111111111110100111001201120121011121020002212212210111111101111110001110010111101
1a011111011111111a101111101101011011111011110001110110111010111101a101111111110111111101011111011011221101110111012200112112012212111101111111110011101111101111
1a111111011111011a011111100011111101011011110011111110110111001101a011111111111011111110101111111110021120111122122200122112011122111111100111111111111100111010
0a111111111111111a111111011110111011111101111111011110111101101110a111111111111111111110111001100111001121122222222002210101222221111111111100111101101111110110
1a011101111111101a111011110111011001111010011111111111110110011111a110100011111111101111110011101111002221212201201221212111212112101110101111111011111101110101
1a111111111101110a111101111011111111111111111111110100111111101111a111111111111111000111111111101111122111210210202111111211100021011111111101111111111011111111
0a111111110111111a1010111111111101111110111111aaaaaaaaaaaaaaaaaaaaa110111110110111111111111011110111221010022122211202020111212111001011111111111110111011111101
1a011111001111011a0111010011111111111111111111a01110010111111011111111101101101111111111011110100110001121210102010220212122211111111111111111101111011111111010
0a110111111100111a1111111111111101111111011111a11111110111111111111011110111111111111111111111111111221112222101200102211212001011111111110111111111101111111111
1b220222121210111a0111011010111111011110110111a11111011111111111111111011111111011111101111111111111120111211002222222120001101121010111011111111111110111111111
0a021212102202011a1101111001011011111111111011a11010111101100110101101111111111011111001111111011111212220212121221210022102212212111001011100111011111111111000
2b212211120121011a1110111111011011011001111011a11111010111110111111111011101111111111111111111111111111122110210111222111212222121011111111111001000111110111101
0a112012002122110a1101011111111111111111111111a11111111111111101101011111100111011111111011111110111221212211220021112211122221201111111111110111111111111111111
2b221101212122101a1110001110101111111111111110a01001011111101100111111011111111111101100110111111100221121002221112022222211222000100111110110101011011111110101
0a110111120112111a1111110111101001011111110111a11010011110110111001111100011111111111101011011111011111102200121001101221111112222111111011101111111111111101011
2a212022211021010a1111111111111111101010010111a11011111111111101011111111111111101010111111111111111112020122101112201111001012212011110111011111101011110101111
2a121211111222210a1111111101111111111110101101a11111111111110110011111111111101011111110101111110011111110220121120011002011221111101101111101111111110110011111
2a112201212212011a1111011110111101111111011010a00100110111010110011111111110111111100110110111111010020121111102200212212011101011111111111111011111111111111111
1a200120212012011a1101111111011111110011111101a01111111011010111111101111101011111111101011111111100222022210112121212221111122222111111010101100011011101111111
1a011110212212210a0101011111111101010111111011a11111101100111111100111111100011111111111011101011101111111111111110101111101110111101011111111111110111111111011
1b222212012010211a1111011011011111100110111111a10111110110101101110101110110110110101011111011111111111110111111111110011110111111111111111111111110011001110101
1b111002211112101a1011110111111111011111010111a11110011110010111011110011101111011110110111111111011100011111111101110111110101111011111100111011101101110011011
1a200221120101121a0111101111111111111110111111a11111111111111111111111111011111111111111111101101001111111110111111100110111110111111111111111101011111111011011
1b202221010022011a1111111101111100111011101111a01111111110111111111101011011100001110111011111111111001101111111011111111111111110001111011111111101111101111111
2b022020012122101a1111101100111011110111101011a10111111111110101100111111111111111111110111111111011101111101101111111011111111110111111111100111101111011101011
1b212121221212211a1111111010111101111110111111a11111111011110111011011110101111101111101001111110000110111111111011111011111111111111010111101011111011101100011
2a022201201111011a1111110111111110011011011001aaaaaaaaaaaaaaaaaaaaaaaaaaaaaaaaaaaaaaaaaaaaaaaaaaaaaaaaaaaaaaaaaaaaaaaaaaaaaaaaaaaaaaaaaaaaaaaaaaaaa1110111110101
2a222221001112120a11110110111111011011101101101110001111111111110100101111100111111111011111111111111111111001111101111111111001111111010101100011a1111100111011
2b221112102011101a11010000111110111011101111101011100111111111110111111101111011111011111111111111111101100111111111011101111110010101111101111011a1101111110111
2b222001222222222b21102212112121111111111101111001110002200101120212110121211202021111110001011111111011011101111011111111101110011111100111101111a1111111111111
0b222201220220121b20220111112120111111011101111101102222111201120211210110101122110011011111111110111111110011011011111101011111111111010111111111a0011111111011
2b122222201022001a02122111221211111110110111011111112122002102011012221102222122221111111111111110011010110011110011111111111010100111111111001111a0101111111111
0b221222222220202a10022222202201101011111011111110110122211112112121122112122102101111110101111111000111001111011101110111111111011111111111011011a1001101111111
1a222222110220211b20112220220111111111111110100101111101122222220122222210121112211111111110101101111110111101011110101111001111111110110111011111a1111011110111
1b222212210000021b12122011211211110111111100111101112220211202010102212221220222221101111011110011111101011111111101111101011111111111111011010101a0101101110001
1a222012022221001a12122211120211111110110011111110011112221112121121221102110021221111111110111111111111011111111111111111111110111111110111111111a1111111111111
1b222212222022011a11212120111011101001111111111101112111221001101201210200211102121011101111101001011101111101110110011011111111110101111100111110a0101101111110
2b220222120222221a22012210212011011111010100111110012201121110212012122211011012110110110001110111111111110111111111111011101011111111110111111101a1010111111111
2b221022220222221b10120211122111100111110111111111112201122212111102012112022222211101111110110111111111111101111000111111111110101110111111110101a1001111110111
1a220222212011121b22202110110201111111111010011111112202112112021111202101112001221101101111101111111111111111111111111101111111111110011111011111a0111111110101
1b021212101212211b20212201212201111011111111101111101102020212211211121202201211211111111111011111111110111111110011110111111111111111101110111111a0111001111110
1b220220202212011b10202021120111111110111110010111111222221101011211100222012212211111111100111100011010111111110101111110111110111110111011011000a1111111010111
1a110000122101221b11221122120211101111101011110011111010211201122211021221212122211111011111111111111111110111111101111111111011111111100111111101a1011111111111
1b211122211112112a12011110221021111111111111111110112212220121002211121220220111111110111111100111011111111101111011111101111010101111111101101111a1111110101010
0a210022201201212b12002202220220111110111111111111101201112222111102122221211202120111101010011011010111111101110101111100011111111111111111111110a1101111100111
ab120212110011220a11211202121211111111111111011111110102212012110201010021022112021011111111110111100111011111011111111111110111111011001111101111a1011011111111
