(117,142)
(102,14)
(56,62)
(46,18)
(11,56)
(69,54)
(81,20)
(10,137)
(18,36)
(57,147)
1011111111101011111111101111110111101001111000002102122211122112222112111111110011110111111111110111101111100011111111101020011012212001120120222200211211101010
1111111111111001111111101111011111110111102212112222221121210200222212211111101101111110101100111010111111111110111101111122012020111222212120210100021211011011
1111111111111111011101010111110110011001020101011010201112022100122212111111110111111111111111101111111111101101111101111112202112011012222211111110111111111111
11110011111111111111aabaaabbbbaaaabbaabbabbbbbbbbbbbbbabbabbabababbbaabaaaaaaaaaaaaaaaaaaaaaaaaaaaaaaaaaaaaaaaaaaaaaaaaaaabbabbbaaaaabaaabaaabbabbabbbbaaaaaaaaa
11011111110111011111a20221210212021111201000222121201111211222212211010101111111111111111111001111011011111111101110001111100222221222212022aaaabaababbbaaaaaaaa
01001111110111010111a10212211211111212000222120222201221001022212211221101011111111011111001101111101111111101011101101101121121212200101210b0101222021211111111
11101101010010111101a11102101211111111011222222211202112122220002120212011111011110100111101111011111111111111111111111100121212201101202111a2111122221010011101
11111111010111111011a20112121220212121111222022122021112111121111211122111011111111110111001111011011011101111011101110111212220122112100021a1111022111011111111
11110111011111111011a10121220201212022221020022222221222200002221121122111110111101111110111111001101111111111100111111101102101212102212101b0111211121001000110
01111111111101111111a21122222001000211200110001202110221122022000200202101011111101100111101111111111111111111101111110101100121021101201222b1220212010211101011
11111111110111111111a212112221211021121aababbbbbbbbabbabaabbbbabaabbaaaaaaaaaaaa101111111111111111111111111101111111111111011112112122212121b2200122121111101111
11101011101101111111a222122122112220222b202220221002120111011122112221211111111a111110111111111111111011100111011101111111102222220201221002b0222021221111011011
10010111101111101111a201111221221220212b222222202222221121211211122211201111111a111111010111011101111011011110011110111111112001201011212220a0112222002101111011
10110111111011110111a112222220012112202b021222112222222122011121110000211111111a111011110101100101110111011111111111011111022212222210111000b0020221110111101101
01111011011111111110a212000211010212101b012120212021112112021221022122201011101a110111000101111111111110101111110110110100011221200101001101a0222211011200111011
11111110111011111111a201121010211222121b022221122221122122101222210212111111110a110111111101011111111110111101111111011111222112001021020122a0211202010210111011
11110111111101111111a222211122021221110a110222222002222022210100121021011101111a111111101110101100111111010101110100111110202212022211200101a0221121201200111111
01111101111011111110a022110211012122011b120202222220011111002222121220011111111a111101111101111101101110110110101111111111100122211120212212b1211212112211111110
11111111101111110101a120211202102110212b122122201222210022222011222210111010011a111111110101111111111111011111011111111111221211022221222011b1211201210211110001
11111011111111111111a220121211201112210a222200211222121122111211222110201111110a001110011101111111101101101010010010111111221220212012100211a0001220112210111110
01110111110011111111a101222111210112120b121220211222020111012112000002110111101a000111110111111111111111011101101111011110212122110221121222b0111222212211010111
11101110111111111111a222202101121222121a222121122110010222111112212221001110111a011011111111111101100111100111011111101111000100021210221222a1201111120211110111
10110111111111111110a220021220111002222a122021210211120222002212222111211000001a111111011011011111011010010110110111111111000112110110112212a0212221210111111011
aaaaaaaaaaaaaaaaaaaaa211112220121021221a222121221221111221011211211210011110011a001111111111111110101111011011111111110111200220211221211222b2011111122111111111
111111111011101111111201221012212111211b102022021222121110222122202212111110111a011110001111011111011111001111111111011111122012021110021110a2222221102211010111
111111110111100010110022022122202022211b221222202202221222210121011001111111111a111101011111111101010101101111111110011110110101111110101101a1110111010111111111
111111111111110011101012111212212122212a121010200111101111010111111010101110111a011101111011110111011111110110111111111111111111111111101010a0110111011111110011
111111011111110111111100022202101012111b221202111101101101111111001101111000111a011110111111111111111011011111101111111111111111111111101100a0111011011111111111
111111110111111111011122211112221121012b101221212121111101111111110101111111011a111111110111111111111110110111010111111011111111111011111101a0111101111111011111
100101111111101111111102221220222221202b210022021020101111100101010011101111111a111111111111011111111111101111111011111101011000111101111110a1011111111001111011
aaaaaaaaaaaaaaaaaaaa1122112121102221222b022212210120111111101001111111101111111a011110011111111111101111111100111101111111111011011111011011a1011110111111111111
1111210212121222211a2021221212220020222a112120121011011011111011011110101100101a111111111111111110111110011111010000101011111111111101001111a1011111111111001111
1112112202120120112b2022202222202212102b110121022200111111111101111111111100110a111110111111111111111111111011111111111111110101111111011111a1111001011111011001
0111222220122122001a0022020112212110110a111110111111011011100101101011010111011a111111111110111010011111110110111110111011011111011101111101a1111011111011111111
0110211022121111112b2202200221122111111a111011010111111111011011101111111011111a111111111011111111111111110111111101111111111111011111110111a1111101111011111011
1111211111121100121b2121121200210111101a101011111101110111011011101111111111110a111111110101011011111111111011111101111111011111011101111110a1111110110111010111
1011212201011220220a1200122221200101111a011111111011111111011111111111111101111a111111010110010111111101111110111111101111111111110110111111a1111100111111111111
1110112121221101220b2202121222121101111a111111111111111111111111001100001111110a101001011111111111111101110010111110110110011011111111111110a1011111110111011111
1102012120122112011a0200210201121110110a110111111111111111111110011111011001111a011111100111011110111101110111111111111011111110101010011111a1111101111111111111
1100210220212102121a2001222122212111111a111111111111111110011111011111101000010a101111111111101011011111111111111111110111110101011111111111a0111101111110111111
1110122222121001222a1122121211221111111a111111011111110111111111111111111110111a111aaaaaaaaaaaaaaaaaaaaa110111111111100111111111101111111110a1011111111111110111
1111202122221202101a2002112122121111010a001101120221012102121122022111110211001a110a1111110011110001011a110111111101110101111110101011110011a1111111011101110110
0011010212010021120b1111011120121111101a111010122101111122122111022120222112211a110a1111111111110110010a101111011110111111110101111112120221b1011021121211122122
1112120122011202112a2012220021221111100a011011120112020220022011222221102112211a001a1101110111101110111a011111111111111100100111111011200101a0222202021012120111
1112021002212010121b1102110101111101011a101111111112012120211021222210010222111a111a1111011111111111111a111111010111101101111111100021102211a2111021101221212201
1102022122211121102b0122111001020011111a111111112000221200222120201022111100211a101a1111011110011111111a111011011011110110111110111100212211b2222122211012211220
1010100201212122221b1020202010001111011a111111112111011222012012222200202121211a111a0111011011100111010a011111111111101111110110111112201112a1222122111021220112
1111220121021211121a2110211220112110111a111111121121102111121100011211111122111a100a1011111110101111111a111111111111111111111111111111121112b1202121201010021112
1111112211122222220a2111111212212111110a111101122002111222021201120021110120011a110a1111011111111111010a010110111111001111111011111010211211b0201111201211100011
1100211222022000122a1021110112101111111a111101122101221011222222110121221212011a111a0111111111101100101a111111110111110111111111111001200221b2012121212211110212
1111110210012011101aaaabaaabbaabbaaaaaaa111111122211212120102221112201012221211a011a1111111110101110101a111011010110111101111111101111121212a1112222221121210220
1110112000122122102122111010121101111111101111111222021012221210201121221202110a011a1111111111111111011a110111111111111111111111001022010200a2011012120122211221
1111121101201000210011112221202101111111011111121220002112111112201121122122001a111a1111111111111111101a011111100010001011111101011101211022a2002122112212112121
0112012111012120110111211222111211111111111011120221220221222112210122201121111a100a1101011111101100101a010111011111111111111101111111010210a2122221212002110200
1112022111121121212112222211011221011111112122210120022220222220202211222022201a111a1111101101011001111a111101111111101111011001111112101002b0212220210122012212
0110120111120112221102221100201101111110012111222221121022222200201000102211211a101a1111011111101111101a111110110111111111110101111112011022a0221210112121121102
1011220112221221022122012112122211111111120120222222122102201022111010212221001a110a1111111111111111111a101111110110111001111111101002022022a2222221221201011112
1110112121202021110121211121122211100112120211221220120202212221222122122200211a111a1111101110110110111a110111010111011111111001011120102121a1021021012221221022
1012221110121111100212000220111210111111111102102201211200021200022110202102211a011a0111111100011111111a110011011111111111111111110021012012b1122211122110220101
0111212210220220120111111222101121011111122111122100022202122222021021002210111a111a1110111100101111111a111111111110111111011111111010001202b1111011121112120202
1111012210121101011211211210111101110111220011221112112222022022221220211022011a110a1111110111110011010a111111111100111110101111111012211120b2011220220212122222
1110111011111111011111011011111111011111102102122021222202222200220220211110010a111a1110110010111101011a110011111101001111000111111121111020a2202011022021102121
1101111011010101100101111101111111111112210222222202022222212012222122122121200a111a1111011101111111111a111111011011111011111011110111122011a2221112011202211211
1111111111111111110111111110100111111101121200122120210122220222222210120212110a111a0111010100110111111a111110111111110011111011111101021022b1222112220201122022
1111111110010110111101111111111110010111022220222222102022102022212222222220011a111a1110110111110110111a111110111011111111101111111122111222b1121101020112111210
1011111011110101111111011101100111111111212211121012222222022222221022102022211a111a1101111011110111100a110011101111111101110011111120110122b1201200112212120021
1101120121000212222201122120201010201110222002121222022122210222202200120221111a010a1011011111111101111a011110011110111111110111111101011222b1202012020012011212
1110122122000222121002111011120121111111021112222222120212222202222001122121211a111a1111010111111111111a111111101111111101011101111122211201b2112112211112122102
1111112212012200112122021020100200011110020212202222112202022222222212122210111a110a1011010111111111111a111111001111110111110011111011210111b2212212211002211120
1111112121210120102021101011122021211111111221110022112122210122012220112210111a111a0110111011101111111a110111100111111110110110111120121001b0021122112001222102
11110222220212112201222210110220110111112211002022210210222bbabbbabbbbbabbaabaaa111a1111110111101011001a110111111010101011111111111012111122a2112122202122011211
11010222212102012221021021012121101111112112110112210202111b02020111010101011011101a0111111110111111111a111111101001010111111111110012100111b1221211122111101220
00111221221202102202110012011110111111011111112010210112121a10121120211111110111110a0110111111011110110a111111111111111010111111111111111111a1011110111111111001
01011112211211121112101212212222201111121101111021220112120b11211222211011101111111a1110110111101111111a111111111111111101111110111011001110a0110011111101101111
11111001211220211122012112020202101111101120221111112111212a10101001111011111110111a0111110111111111011a101110111111111111110111101101110111a1111111111111111110
01011000021212210021211222120111101110102221012212100111101a02102112211111101111111a1110111010101111100a110111011111111111101110111111001111a1111111011111111110
10111102102212111012221012101011122111111111021111220111220b22020221011101101111111a1110111011110011111a111111110100111111111111101111111111a1111011101111101111
11111022202111101012021222011121202111101111112112002211202b01211201111011010111111a1110101011110110011a101111011101101110101100111100110101a1111111101100001001
11111222001011122210021210102022011101022102112210122010021a20122211111111011001111a1111110101111111010a111010110101111111101110101111011111a1111111111101111111
11111010022111212011122120112222220111101101212212220222122a21111012111111111010111a1011001101110011110a111111101111111111111111111010011101a1111111101111010111
11111110210222122111121111002210200111122121222001120120021b22202122111111001111111a1101111111101101111a011111111111111111111001111111011111a1111110110110111101
11101120111112212211212121102220111111110202122120210101210b21211021100101010111101a0111111111111111101a011111111011111111000011111110100111a1011110111011111011
01111221212021101212210022222201021111111221220222221222120a12020012111111011111111a1111111111101011110a111011111111011110101011111111111111a1111111111111111110
01010010122011221122121112112121202111120002221102011022211a11202112111101101101011a1111111110011011100a111111111111010011111111111110111111a1111110111111011111
11111021121202101202112112122101212111111111101111111111111a11011111101111111111111a1111011110111111110a111001110101111000010111101111111111a0101111111111110111
11111222222012012112122112012010020100110101011111101111100a10111111111111111110110a1110110101111111111a001111111001111111111111111111111111a0111111010111111101
11111022110102221201112112101102201101110111111000110111111a11111001101111101101111a0111111011111011111a111011010111111110111100111111101111a1011011111111100111
11010112012012201101201221120011122011110111101111111101101a11101111101111101111101a0111110111111110110a111110101001111111111101101111011111a1111110111011111101
00101121222102221122122110022122221111111101101111111111000a11111101111111111101111a1111110010111111110a101111001111111110111101111101110111a1111101010110111000
11110221112221001222111210222110221111111101110110110111110a11101111100111011111111a1011111011100111111a111111001110111110111111110111011111a1101101011111110111
01111122021122201221220212212111121111101111111001111111111a11100111110011111011001a1101011111011011111a101110111110101111111100101101111010a0101011111111111111
01101120202222111110222111021000112001101101110111101011101a10001111001110001111111a0110110101111101111a110110110110101010111110110010101111a0111110010000111111
11111220011121221022102211211110122111111110110011110011001a11101111011110001111001a0111111111101111110a100111010111111111111111101111111111a1011111110111010011
11111101202212221112222122122111212111111111110011001100110a11111111111111111111011a1110011111111111101a111111111011111001111111111111111111a1100110111111111101
11111222210212222121121221112111200111110111111011111111011a11111111111101111001111a1111111111101111111a111111111010101011111110111111111010a1111011111011010111
11011211112222102211011112121211121110011101111111111111011a00111111111101111110111a1010111011101110101a011111111101001011101101111111111111a0011111001101111101
11011111111111100011110111111110011111110110111111111111011a10111111011111100101011a1110111101110110011a101111111111111011111011110111111111a0001111010111111111
11111011111111111101111110111101110110111101111111101011001a11111100110111101101111a1111010101111110001a111111111111011101111011011110111111a1101111110111111111
11111111111011111010011111110101111111111111111101111111111a11111111111111101100010a1110111111111101011a100011101111011101110101111111111111a1110100111011111011
10101101111011110110111111111111011111101101110101111011111a01011011111111111110100a1011011111110111111a101110101011001101111101111111101101a1111010101111110111
11010111111111110011011111111111111111011111111111111111101a11111111110101001111111a1111110011110101011aaaaaaaaaaaaaaaaaaaaa1111111101101001a1011111111100111011
01001111011111101011111111110101111101100011111111011111101a11111110101011011100111a101101111111011111111110111011111101111a1011110111111111a0111110110011100011
11011011111111110111111011110111111111101101111101111111011a11111011110110110111111a111101111111111000101110111011001111111a1101011010111111a1100101111111111111
01111111111111101111111111111111110101111011101111111111111a11111110000111111101111a010111111111111100110011111111101001111a0111110111011111a1111111111101111011
11111111111101011111101101111110100101111111011111111111111a11101111111110011111111a101111111111111111111111111011011101100a1111111100011110a0111001110101111111
00111111101111100111111001110011111111111111101100110101111a11111101111111111110111a111111101111100111110111101111110111110a1111011010111111a1011101111001110110
11111101110111111111101111100111111111111111111111111110111a01111101101110111111101a111111011111110001011110111111011111010a0111011101011111a1101011101111111111
11011111110111001111111111111110111110111111011011111110111a11101010111100101110101a010111111011111100110111111110011011111a1110111111100101a1110111110111111110
11111111111111101111011100111111101101110111111100110111110a11010111111111111111111a111100111011111101100111111111111101011a1101111111011110a1110111010110111110
11101111110001101111111110001111111111111111111111110111111a11111011011111111111011a111111100110111111101110010111100111001a1111010111111111a1111100011011111001
11111101011110110011101110100100011110100111011101111011110a11111111000111100110111a111011100111101110111111111111111111111a1110011001111110a1101111011111111100
10111010100111111110110101101111101101011101111110111011111a01011110111111101111111a110111111111111111111111010011110101111a1111111110111111a1000111111111111111
10110101111111011111111111111111100111111000111111011101111a01011111111110111111111a111101101101101111111110111101111111100a0111011110110111a1111111111111111111
11111101011111101110111111111111100111011111111111110110011a10111111111111111110101a111111101011100111111111111111110110110a0111111111101111a1101111111111111111
11111000001011010111101111111100111011100100011101111111101a11111011110111111111110a111111111111111011111111110011111111101a0111101011110101a0110111110111111101
10111110011001111011111111110111111111111111101111011110110a01011011110111111101010a111100110101011010111101111101111111011a0111011111101110a1111111111011111111
11111111111101111010001011111101111100111111011111011111111a11111011101110111111101a111111110011111111110111111111101111111a0101101111101111a1101110111111011111
11111110111011111001110011110111111111011111110111111111011a10011100111011110110111a100111101011110111111011111111110101011a0011010111111101a0101111111111111111
11110111111111101011111001111111111110011101101110101111111a11011101111111001111011a111111111111110111101111101111111110111a1011111011111101a1101111101111010111
11111111110101111110111101111111101111111111001111111011111a11111111101111110110011a101111111111111111110011111111111111011a0110111111111010a0011111111111110011
