(17,151)
(80,10)
(35,153)
(11,110)
(30,35)
(55,74)
(41,158)
(99,48)
(70,133)
(46,87)
11101110111111111101111110101101110011110111a111111111011001101100111111011111110001000100011111222110121200201100202111102011101111110110111101a111111110111111
01111101111100110010111111011111010111110111a111101111111111111111111111101111010111111101111101120120122022222110121211021120111111111111110111a111111101111111
11111110011110111111011110111011111111101111a111111011111111011101101101011110011111011111000111112101211212110022012111022111010111111111011101a001101111110111
11111111100111111111111111111111111111111101a111111111111101110010100101111111111011110111111111121101120110122102102121021211111101111111111111a101011101111111
11011101101111101111111111111101011111110111a111111101110010111111001111111110111101111111110110122011122010212010212112012201111101111110111011a111101111111101
11100110111101110111111111010101111110110111a011111101111010011111011111111011111100111111110112102212201210210112201221221211111011111111111100a111101101111111
11110101101111110110111110001010111111111111a111101110111101110111011110011011101110111110110102202112111111222202100221210211000111111110110011a011110111011110
11100111110111111111111111111011111011111010a111111011111111111111101111011111111111111111111111120202211211101222221202111221111111111111111010a111111000011101
10110111111001111111111111111111110110111111a111111101111111110011111111101101111011111100101012110211211221112211122101211110010111011111110011a010111111111111
11100111011111010111111110101111110111110111a101111110111101101111111110111111101010111110111101011211220121112112220011021011011101111101100101a111111111111011
11111111111111111111111111110101111111111111a111001111111010111111001111101111110110011100101112221112022022012121100120121211010011011111111111a111111111100111
10111111101111100110111011010101111111111111a101111111111111011001111101110111101101111111111010011211102120211212122211222221101011111010101111a011111110111111
11111111111111111111100111011111111101111101a111111111011111111110010111101111011111110100111101222220101002211121201022000021111111111111111111a101111111100111
11111111011101011111011011111111111111110111a011110111001100111111111100111011100111111111111112220022221211210111121122212110111111111101111110a111101111110001
11010011111111101011111111011111111111111111a111110110110101111110101101101011111111111100111102212222101120111222211112111101101111011111111100a110000111111111
11011111111111111111212222211210211201110010a211021100011110101111101111111110110101111100111110101211200202010201211222212111111101110011110111a111111111011111
10101010111011111111211021021101112112211221b122221101111110111101110011111111101101101000111112120012112212121121021211220121111110111111111111a011001111111111
11101111111100001011121101112222102000212221a212211011100001111011101011111111111011111010101111221222221220210221002221012101111111111101111011a011111111111011
10111011111111100111101221221121112111201020b222021111111001111011111111111111111111100110111112112102022202211122212220220221101111011110111111a111111111010110
11100111011111111111210210111120111112101122bbaabaaaaaaaaaaaaaaaaaaaaaaaaaaaaaaaaaaaaaaaaaaaaaabbbbbababbaaabaaabbaabbbbbbabbaaaaaaaaaaaaaaaaaaaa111111111111111
0110011111111011111101021122221220121212011110122211001111101111011111011010110111011111111111112221101020212022011222221222211110110111011111011121000222112110
1111111111101111111021220202102221202022210022022201111101111111011111111110111111111111111011121101211202101112121222220000111100111101102212221002220220221100
1011111111111111011112022221101112012120111121220111111111101101110110111111001111111111111111122221101120212220121110111121111111111111111022211101212210112211
1110101101011111101121221212112212211201021012211111100101110100111111111111111101111011111111021211221121102122202110121121101111110111102021200121202112211102
01111011111111111111110101010111202211222121211212011001001011011111110111111111aaaaaaaaaaaaaaababbbaabaabbabbaabaababbbbaabaaaaaaaaaaaaaaababaaababaaababaabbba
11010111111101110101212222222112210211202122110112111110111101111111111111111011a1111110111111111222111120010222112221012221001011111111110012111000111210102110
11111111011110001101102021111112222022212221101021111011111010101110111111111111a1111111111010111110011111111111011111111011110111111111112210121010022012212221
11111011111111011111102022020212010121220212222002000111111111111111101101111111a0000111101111110110110110111111000111001011100111110111111212002220221121220022
aaaaaaaaaaaaaaaaaaaa221121211212112112211222022222101111111101011011111111010111a1000111111111011111111111111111111001011111111011110001002211211212022112222222
1011111111111101110a010112212221122211021221022012111111111111000111111111101110a1110111110110111111011101011111111110010110111110111010102122122222221222210221
1110111111011111111a120220120012020000111211210022011111110011110101111111111111a0111111100011111111111011111111110111111011111111111101112111222202112122121220
0111111011100111111a211101221112121210122112012121111101111111110111111111122111a1210112021222021110101110110011111111111111110011111100100210222212221221020212
1111111101111011111a210011101011021220202021012211111111111111101111111112220110b0220101221120212120120111110001111111110011101110111101011111101222022210002221
1100111010111111111a102002012222211212010022110200101111110111111101101121011201b1120212120222111110121111111111001111110111111111011011111011202202122110212211
1101111111111101001a120111121112201102011210121120100111011111111111111122221001a1222011011201202212111111111111111011101111011011101111010121122022222222211220
1111111111101011101a201101102112102122010012212110111101100011111011110121121122b1011222211222102101210101111110111011001111111111111111102221002221212120022222
0111101001010101111a222020100221001202112112212222111101111101111110011120120021a1212112012021100202211111101111101111111111010110111111112112021112122221222221
1001111111111111111a210121022111220110122111111100011011110111111111111112111222a0102202222212112110100101101101001100111111111111011111110222122020202122212212
1111101111111001110a012110111101111212202221212212111111110011111111111121201011b2012121112211202110210111111100110111111101111001011111112111221222101202122212
0101101110111111101a021112211111001211111111102012101011111111111111101110211112b2112110111222221212211011001001010111100111111111110101111112022222220212222222
1001001111111111011a221211201120011112022011122221111111111111120111222220022122b0220122001021221122100111111011110111101000111011111011112122102222222222120222
1111110111111110101a121020112020122011222212112102111011111211020101221022100222a2000112102212221211111111110111111000111111111111110111112110201111222222201201
0111111101111111111a211112001111121020020222012222101111111220000122201122202222b2211202212112221221021111011111111111011111111011111111112112022222122222022022
1101111110011111111a221012122222111010222121021001111011010021221110212120200222b2022222012112212101111110111100111111111101111011111001112022222220221212012222
1101110101111111000a212112111021111120121022211222111101111111211222201122021210a2122222222011211012211111111111111111111111111011011111102110122122222120102202
1111010001010011111a110111111111011011111111110111111111111021110101122222222100b2222121121221021221111111111100101111111101111111111101111002222221212021222222
1111111101101111111a111011111001111100101011101011110111111111222211211222212201b2021221220022002101201111111100111111111011101111001111111202121220222222212221
0101111101111111101a011101110111111111011101110110011110110222101221022121101010b0220220222012222112221111101111011001111111111111101011010022212021220211222001
1101101111101110111aaaaaaaaaaaaaaaaaaaaaaaaaaaaaaaaaaaaaaaaa01201221001120002222a2201212211220112110101111110111110011011101111011101111112022122200201002202201
01111111111010111111101111110101101101111101011111110101111a11121122121020022022b1222010112221221211111010111111011111110101110101011111112022022012102221122122
10111101111111111011111110111001111111001111010111111001111a12210222120022222200b2112011222111210221121011101101011101011111011111111110111110112221211102002011
11111111100110110110011111011101111100111111111011101111111b11212120222121202212b2121202120202022011111111001101111110111111111111111111111011122211222210101222
11011111101101110110111111011110011111110111011110011101111b21211211002211121122b2222022221112201122111111110111110111111101111111010111111111122220012122122112
11110110100100111111111011111111101010111111110100111111111b10012111112211220222b1222220212202122221110110001111101101011001011111111111111101020011111222020020
11111110110111011001101111101010101101110101111111111111111b10122210110202202021b2102002210101221222211011011110111010111111111111111011101011102222211012121002
11111111111111111111110010111010110100110100010111111111111b20201202112222021122b2222020221122220110201111101011110111121122111012011002222120121222112211212212
11111011111111110111111111011011111101111111111111111111111b20121012120020122200b220201221211121221201101111011111011121babababababbbbbaabaabbbbbbbbaaaaaaaaaaaa
11101111010111110111111011111110111010011101111101111110110a20122220121122221202b020120012221020122011110110111111111121a202011120221021112111221002101001111101
10010110111101111111010111111111111111111000111010111111101a21122002221111222120b021022020121201111110011011111011111120a021222101120122001011212221111111111101
01101111011111111111110111111011111011111111111010111101111b10210222111011022222b212202020110002200021110111011111011122a210112020122211020002012120111100110110
11101111111111111110111011111111111101111001111111111111001b11112211110121222200b110222121212120222102011010110101111122b021211100012221020220112122011101111111
01111111101011111111110111110111111111111011111101111111111b11210101210212212122a010111111011101011111011110111111011100a202222000120020120011201221111110111101
11101111111111011101111011110111111111111111111111110111111a22202211121222021111a112220110111111111111110010011101111101a112121201122112020022220101111110111111
00111111101100111011111100111101110110001001111111011111011a12220122220111021220b120212110101100111011011101111111111120a110111121022001000022101122111111111111
11011110111111100111111111111011111011111110111011111110111b12102202021221212112b221212021011100111110111101011111011121b220222122112111211222202212110100000101
11101011011110111101110011001011111110111111011111010111111a00211102212110211212a212111111111101111110111111111101011012b100012202120111222201120102110111101011
11101110110111111111110111101001111110011011111111101110110b12110011222220121201b021011020011011011101001011111111111011b200200120111212122211222110100111111011
11111011111111111101111111111111111110111111111101111110111a21111211221022102211b212201101101101010110000111110011111121a201221012202021020010202201011111111001
11101101111111100111001101111011111101111111111111101111111b10011211221111211002b112102021011010111111101011111111110120b102112212211212121210210201111111111101
01111101111101111100100111111111011101111111111111111110101a01001212112110111122b201111011111111100101010111011101000111a201202201021011021222212111110011111111
10111101111111110110001111111111101111111111111011111101110a11111111110110101110a110111111101111110110111101101111111122a022210122101202222121122111111110111111
11111110111101110101100111111111111111101110110111011101101a11001111110111110010a110111100010111111101111111111111011110a120221202111112111220210022111111111111
01111110111011101010101111111110111111111011111011111111100a11111111111101010111a111101111111111110111111101101111011120b122212012222100022121222211111101101111
10011110011111111111111011111100101001101111111101100111011a11110111111011011111a111101111111111101011110111110011100022b221200022222012211212122112111011111111
11100111010101111011001111110110111110111111111001111001111a01101011111101101111a111111011110111101111110111101101010122b120201011212211011211210122011111111011
10111111111111001111111111111111111111011111010111011111011a11000111011111111111a011111111111111011111111111011111111102a110001101211220202220121221111111011101
10010111111111011011111101101110111011101111110111110111110a11110011111101111111a111110101111101101111101111111111101121b221201210101022122120101222111100110011
01011111101101111111111101111110111101111111100001111111011a10011111111110110111a111110100111101101110100111110111111012b112122110221122202110100120111110111111
10100111111000011111001111111111111111110111011111101000101a11110111011111111110a111011011111111111111110111110011110011b101120111211222011222122021111111111011
01110110101111111100011111111110111110111111011110111111111a11111011111110110101a010111111011110111111101101110111111121b100021220112222220200210222011011111111
11111101111111111101111100111011111111101110110101111011111a01001111111111111110a011111111110111001011001111011110111111a222121222220201201111120101010111111111
11111011110010111111111111111111111011111111010111110111100a01111111111111111110a111111110101111111111011111101111111112a112022001211221111110122201100111001111
11011111010101111001110111100101111110110110101111111111111a11111110111110111111a100111011111100101111111101011111111012a020111102211212200112121222111011001011
01010110110111111111110101011101111111011010011111101111111a11111101111111111111a010111111111110000111111111111111011101b212122210211221110110210222101111001111
10111111111110111111111111111011112221110211212022122011212b21111011110011100111a111111101110111111111100111101011111121b021212212021022202122112121110101111011
11111111101111110111011111011111011121021012121202111221212a22111110110111111111a110111111001111111111111111101111111011a011111111111111111111111111101100111110
11101111111110111111110111110110112122221102201011211120101b22010010111111111111a111111111111111101011011111111111111111a111011111111111111111111111011111110111
11111111111111111111101110101111111122212110212111201221102b01211111101111110111a110110111001111110101111111101111111101a111111011111111101111111111110111111111
11111111111111110111110101101111121111221210111201011222221b21211110111110011011a111111110111110111111111011111111111101a101111110111110111111111110101011110111
11011111011011101011010011110111122201000100100200122111110b11111110111111101110a111111111111111101111111100101111111101a111111011011011111011111101111001111111
11011100111111101111111101111110122221222111112001101122010b22211101110111111111a111011101101111111010111111011111111110a011111010111111011111111111111011111011
11100111111111101111111111111111102122210222000120111112121a02211001111111111010a110010111101111101110110010111110111111a110010010111111101111110111111011110111
11011111100111111101000111111111121212201012211001210122122b22011111011011111111a011100111001111110111111111111111001111a111111111111111001111111111111111101101
11111111001100111011111001101101012212201221110222010021121a11111110111011111101a111111111111111011111111111101111111011a100111111111111111111111111011110111110
01111111111101110101111111111111122220122021011210110210222b12211110111111111111a111011111011110111111111000111010111110a110111011101101111110111111111111010110
11111001111111010111111110111011121122222220202211222121222a11111111110111111111a011111111001010111111111111111111111100a011101100111110011111111111111111111111
11101100111001111111011110011111121121111121212011122122102a22211110011111111100a011011111011001110111011111101111011111a110111011010011101010111111111111101110
11111110011011111111111010110110010211220022011010222211121b21011111111101101111a111011111010110111111011001111111111011a010111111110111110101110111111101111011
11101101111101111110011001111101122201002221220020210221110b12110011110110110111a110111101111111011111001011110111111011a101101111111111011111111111011111111110
11101011111110111110111111111100122111020221210221022120121b12111101011111101111a111111111101111101001111111111011111111a111110100111111111110001000011011111011
11111111011111101111101001111101122121122222222210111120222b12110101111110111110a101110110111010011111010111111111111111a110111111111111011100101110111100011111
11100110010011111111111101111111122112002211222022221220122b02210010111111110111a111011111111110110111101111111111111101a111010111010111011101111111110110111101
11111110110111000111110110111111121120222002210012110100121a12111111110111111101a110101111111100111101111111111101111101a011111011111111100111111111111101111111
11111111111101111101100111110011112012121112220101221222111b22211111001111101101a111111111011111111111111011111011111100a101111111111011011111111111111111100111
11111111010111111111101111111101021202112000011222212100022b12211101111111111111a101110111111111111111111111111101011111a111100010101111111101110001101101111111
10111110111111111111101111111011110202102222221122121002221b20211101101111111111a111111011011011011100111111110011110111a111110011101101011111010111011111111111
01110111101111001110111011100111101011212102011102121111002b01011111111011111111a111111110101111011011111110001110110101a111110111111011011111101110110111111111
11101111110111110111111011111110112000221112212021222221122a21211111111111110001a111110111111111011111011111111111111111a111111111011110101111111111110111111111
11011111111110110110111110101111112100111112210222022111101a21111111111111001100a111110111001111101111101111001111101111a011111111111011111111101011101111101011
00001110111111011110111111111011121121110002120121100111122b21111111111111101111a111111111011110011110011111001111110101a110111110101111111111011111111111011111
10110011101111001111111111111111010121111102212111122022212a12111111111110111111a111111111111101111101111111111111110011a000111111111011011111100110011111001111
11111111111110111111101111011111122020210002211212211222012a11211011111110110111a111111101101101111110111100111111111101a110111111110111110111110110111011101111
11111111111111111101111111111101111121022211221201112221212a20201101111101110001a011111110110101111111111111111010111101a110111111111111100001000011111111111111
11011111101011111111111111111101121112101202022201222112211b11201111111100110111a110111111111011110111111110111111111101a000111111101110111101100111111011101111
10000110111111011101101111010111111111111111110111101101011a11111101111111101011a110110011111111101111111111111111101111a101111111111111111011111110101111110010
00011110111111111111111111110111111100111111000111111011110a11111110001100111111a111111100111011111111101111011111111111a111011011100111111110111111011111101111
11111111110010111101111111101111111111111111111101011011111a01101111111111111100a111111101101111111011011101110111011111a110111111111111110111110010111110110000
11100111111101111110111111011111110101110111111101111101111a11111111011110111110a101011111111101101101111110110110111111a101111101111111111111101101100111111111
11111011011111010101111101110111111111110011010111111101111a11111111111111010011a011111011011100111111111111100111111101a111110101101111111011111011100001111111
10111100100111111101111100111101011111111000111110110111101a11111111111010000111a011101010111101011001111101100111101111a101111111110111111011101111111111111111
