(119,52)
(20,3)
(40,61)
(78,127)
(34,9)
(75,109)
(83,157)
(69,36)
(110,119)
(81,34)
111111111011100111111110111111011101111101111111111110aa101111011111111110111111110101010111111111110111a111a111101111110011111110110111110010110111a00011101011
110111101111110110011011110111011110101011111010101111a1111111111111111111111111110111111111111110011111a011a110111011111011011111101111011111111110a11111111110
111110101100011111111111111011111010111111111101001011a1111001100110111101111111111111111111111101110011a110a101010111100111111001011110101110111111a11110101111
011111111110111111111101101111101111111111111111011011a1111111111111110011111110111111111111100111111111a110a010110111111111110001011111101011111101a01001111111
111011111111111111011111111111111111011010111011111110a1101111001111100111101101111011111111111111011100a111a111111101110111101111111101011111101101a10101010101
101101011110110111110111111101101110111011111111111111a1111111110111011011010110110101001111011110110111a111a111111111111100111111111111100101101111a11101111111
111001101100110111110011110110001111111110111100111011a1110011011101011111111101111111011111111111111111a111a111111111111001111110111110011101111111a11011111111
001111110011100111101101111001011100111010111101111111a0111111011111111100111111111111111111111011111101a010a011011000111111111111111111101111111111a11111111111
100101101011101011111111111111111111101111010111111111a1101011111111011000011111110110111111011110001111a111a011110011011111111111111111011111110110a11111101010
111111111111110100111101111101101001011001111101111101a1110111011111110110111111011111111011101111111111a111a101001010111111111101011110111111111111a10111101110
111111111111111111111101011110001111111101111111101110a1111111101101111101111101101111111111111101111100a111a111001101001010111111100111111111111111a11110111111
011111111111111010011110111111010011111111111111011011a0111111110011111111010111111011011111111011111011a011a110101110101111111110111110110111111101a11111110111
111111111111110111011111000110111111101111111111111010a1101101111111101110011111111110110111111111111011a011a111110011100111111111110110111101111110a01111111101
110111001111011111110101111011011111011111011101111111a1011111101101111111101111011101111111110111011111a111a110111111111101011111110111110111101111a11111111111
100011110110011101111110111101111101111111111011011011a1110011111111111111111011111101111110011110111011a110a111111011111110111110111111110011011100a11111110101
111111011111101110101111101111111111011111111110101111a1111101011111001110111110011111111011111011011111a100a010001011111111111110101111111111111111a11011101111
011110111111111111111011111011101010111111101011000001a1111011111111100110101110111111101011111010111110a111a111110111011101111111111101011110111011a11101111111
011110011111111101100111101111001011111110111011111101a1111101111001111111111110111111110101100100111111a111a111110111011111111111011011111101110111a10101111111
101111111111111111111111100011101101110111101111111011a1101110100111111011110111111111101101111111110111a011a111111110111111111011111011011010111011a10111001111
020101200101222120112211011101111011110011011110111111a1111111111110111101111111111101110011011011101111a110aaaaaaaaaaaaaaaaaaaaa1111111000111011111a01111011111
222212122220201201011201110011111101011111111011110111a1111101101110101111111111111111111111111111110111a11111011111100111011110a1111111111011101111a01111000111
212220201101220121201011111111111111111010101111110101a1111110111110111111101101111110111111101110111111a00111101111000011101111a1111111111011111101a11111111111
112112021121200212111212111111111101111011111111111110a1111111111111111111111001111111111111111111111000a11111111111110111111111a0111100111111111111a11111111111
111010111112112211222210111111111111111101111110100111a1010110111111011010101111110111111111111111111111a11101111010001011011111a1011111001101111111a11110011011
222212221000101011211110001100111111010111011011011111a1111011111101001110111111111011011111111110110111a11111111111101101111111a1111111111111011100a11101111111
221021112212121210212222111111111110110110011100101211a1122111002211022021211111110111111011111111001111a01101101111111101011110a0101011101111101101a01111100111
221202012020121222121200101110100100111111110122122000a0212102212222112202201111001111111111011111101110a11110011111111101111111a1111111111001111011a00110101111
222222022121110020102202011011110111111111100122220220b1220122121011211120211111111110111110111111011010a11111101111110111111111a1111011011010111111a11011101111
212111112201012122112222111111001111111111110112002211b2102111221110210121211110011111111111101111011110a11111111111011101010111a1101011111111111110a10111111011
002222202010101120112212011111111111111011011022111121b1120220212201020222111011111111111110001111011111a10111011101111111100111a1111101111111110101a11101111111
120112010012220112112101011100111110111101001110120102b0111211021100202111221111010111111111111101101111a00110010111111101111011a1110111111111111111a11101100111
101121122012221211121112111111111111110011111121220102a2101210011221221101211001111101011111110101001110a10111101101001111010010a1111111111100110111a11101101111
210122212121121211202121111111111110111101110021012121a1212121022021002112201111101110101011011111101100a11110111011111111111001a1011111111011101101a11111111111
202022121110211121211212111111111011111111111020222002b1112212212102112120221110111111101111011110111101a10111110111111111100110a1101111111111101111a11011111101
102212111020121222111202110111000110100111011122222122a1201212111112101112011111111111111011011110011010a11110111101010011111111a1111111110111101111a11111100111
221121200111111021022022111111101111111011111022101220a0112211222012111100211011111111011011011100110111a00111111110111101111011a1111011101110111111a11111111111
112211112210122222012222111101110111101111101101210201a0200012012212110120221011101111010011111111111111a11110111111111101101101a1111101000111110111a11111011110
120012122012111112222020101111110111111011111011021221b0211212020212022222121010111100011101111111110101a11011111111111111101111a1001101111010100011a01111111001
222112210021112010111211110111111011101111111120122100a1110112211210222201121101001111111001111111111111a11110111101100111101110a1011110111101011101a10111111111
221210121221202112121202001011010111011101111110222010a2222022201212122202011111110111111011111110111110a11001111111111111111111aaaaaaaaaaaaaaaaaaaaa11101111111
220022212122112020000011111110101011111110111102222220b2111021120102000220101111111111111111111101101110a1111111100011110001111110110111101111111101010111011111
aabaaabaaabbabaabaab2101011111011110101011101120111110b2222122211222220100201111111111111111111111111111a1101101111101111101110111111110111110100111101111111101
1111111212222201112a2121110011111111111111110121212211a0112002202122111222010111110111111111010101101101a1111111111011111000111111101111101111111111011111111101
1101001012211102120b1012101101110110110111100110111220b1222122110121012221210111111110111011111011110101a1110111001101111111111111011111111101110011111110111011
1121222022020020222a1122111101111111111111111120100100b0111210012122221220111111111110111111111110101111a1111111001101100101111011111111111101111111011111111101
2220112102212011011a2001101110111111111101111121222222a0210021012222110122221111110101011111111101111111a1111011110111110111111110111111111101111111110111111111
2212212211120022111b1122101111111111111111110012100211b2212222112100211021121001111101111101111111000111a1011110110100111110110111111110110111010101111111111111
0122111021111212222b1120111011011111111101111111202100a1222011202221111110221111111100000011011110111101a1111111111110111111111111011111111011101100011110011101
2112202222200221221b1212111111111111111111101110122122b2221021211212012212111011111011111111101011110011a1111111110110110101111101111100101101011111111111111101
1111101101111111101a1111011111110111111011111121201102b1121212122111121122101101101011111011111110101111a1111111111111111010111111111111111001101111111111111110
1001110111101101111a1111011101110111111111111111020112a1022210201221111222211011110110111001111111111110a0110101111111011010111111111111011111011111111101101111
1001011001100111110a1111111111110011110011111102220121a2112122222212102101021111110111110110111011101111a0111111110111111111111011110110111111111010010110111100
1110110101010101101a1111111100111111101111010102110112a1112110201211222022121111111111111111011111111111a0111011111111010111111111110111111011111111101010011110
1111111111111111111a1111011010011110111111001111211221a2202101210221210122221101111101111111000111011011a1101011111111101111011010110110011111010101011110111011
1111011011111011111a1011101122120120021212010121200111b1222110101220121022200111111111111101111011111110a1101110111101111101111101111111111110011111011110111111
1111011001110111111a1121121202212102201122212210101111a1010100110111001111110001110111111110110111011010a0111111111111110111111101111111111011111000110001011111
1010111110111111110a1220121112210221112111110212122111a1111111011000101110111111111101111111111100111110a1111101111111111111101111111110101111111011111110111011
1011110111111111110a1011112021101202111010222001012011a1111111110011111011111111111111110111111111111100a1001111111111011111111101111011011101111110111111111111
1100011111110111110a1111111222002211210122122120220111a1011110110011111111111110111011110111111111111111a1111111111111011011111100101111111111111101111111111111
1111111111111010111a1102111201111200111211212111222100a1010111111111111111110111111101110111110101101111aaaaaaaaaaaaaaaaaaaaaaaaaaaaaaaaaaaaaaaaaaaaaaaaaaaaaaaa
1111111011101001111a1111120201011122200220221010111110aaaaaaaaaaaaaaaaaaaaaaaaaaaaaaaaaaaaaaaabbbbbaaababaaaabaabaa122101102101111111111110011110100111111001111
1011111110111110011a1122222212021001212121221221110110101011111101111011011111111111111110010122112120121212001220a120111201111111111001011111111111110111111110
1111001111110111101a1220212202220110121121121021202011111111111100101111111111110011101111111012221211210112100222b212222201111110110110111101111011110111110011
1111111111111110011a0011001122122012012012220110101101101001101111011111110111111111111011110112111210111022101222b121112221102110211212102211111111111111111101
1011111111111111001a1212211210112202111211112210220111011011111101110111101111011100100111111012111111220221112122b202021220222221211222202221101111111111111111
0111111111110111111a0110012112112212122110202222011111111111111111110111111111111111100111100111212111112000110002b212221221212210210221121112111111111111111111
1011111001110110101a2122221022202022202101112222212111111011111011110111111111111001111010111121211122202120121222b201000002210100221120102210111110000010101111
1011111011010011110b1221022222021212221210001201111110011011111111111101111101111101001111111020111212022222111220b022120200222211210100211211010110111110111111
1110110110110111011b1202221222222222212202221102200111111101101010101111011111111111111010111111221212101121210222a222221221221102112222110012220012211011202211
1101101111111111111a0221200022122022221101221122121110011011111011101111111111010111111111011122222102112121110002b200122222010201222211112122122021111222120201
1101101101101110110b1222222122022212202201020022020110101011110101111111111111111011110011111112201121011221211222a021022222221201212211022202112222102110000211
1111010001101111111a1222022222212100221202012200221111111011101110111111011110111111111101111102222220111212202222a220221221222212010012222101111210221221120101
1111111011011111111a1222012011122222120222212222112111011110010101111111111111110010101111111120201201102112112012a112222121121100220022101210222000211022122222
1111110100111111111a1222121222222100021022202222121111110111111101111011111010101111110110110122122111002202222101b222022222011202222002122021222100111220222111
1110111001101110110b0021112222010222202212212122222100011111111101111011111101111111111111111102100010112210201222b222222202110202122120111010102021012221211012
1010110111101111111b2220121221222120121221021221011111111110111111111111110111111000101111111121111121112111212221b222222222111222122212122101102202221120202012
1111001101111001111a0202110222222202212222222222020111111011011111111111111101110011111111111121211212220201102122b222121012222121121111201020102121021012222212
1001110100110110111a2110022002002120201100122220201110111111111100011110111111110111011001110002211220120211112120b222122022121120020111122202202122202112111110
1111111111111101110a0202222211222200211222011222220111011111111111011110101110110101111111111100220120211112211120a222222022101121220112022200120222101202221011
0100111111111111110a1000102222222122110121022201212110010111011101111011111101111011111101001022102111212120211212b222221201112101221122111200201121122220211220
0111111110010011111b1220222001202122220221211221020110110111111011111100111110111110110111111121111220020121101120b220202222212101111112222221201222211221212011
1111111101011111101ababababbbabbbbbbbabbbabbabbbbbbaaaaaaaaa101111011111011011111111011111111111212200222121102220b202202020112210112021202111212122111012021121
10111011011111100112201112022122012012021220202121210011101a111111011111111101101111101111111111201122222220121222b222100002212011210012222220120221102120212222
11110111111111111112102202222221220121022221222221111111111a101111111111110111110111111110110122020011222212021220b220222222000202101122112120201020121111220201
11111111111011100111122222211211012222201101122011011111111a111111011111111101001101111111001001221012212212002022b122012012122121212112222122122122211121111211
11110101111111111111222221212012120221221222022021110101111a111111111010111010111011111111111122222122121110111120b022002202111121120212212101021101022221221201
00111111100110110112102211111012201212000211201201111001111a101111110111111101110111111111110102211022222222020112a100222212122111122111112011122111211221020201
10100110111111111112011112221112021102221220122210011111111a111101101011101111111111110011101100211111121010101202b202202111210220021211211121111211100101111122
11000111111111111010021012000202020200112210012100111111000a111111111111111111111111111111111102220222210212112212a220220212012122112101112110121102120222220010
11111111111111111011212122111222221021102021222121110111111a111110101111111011111111111111001122022121021112221221b002212202212220221202101111220021012121022111
11111001111001101112201222210002120122212221200221110111001a111011101110111111011110111011111111101111110111111122a012211111111120221010012112220121100222120122
11011010101011111101212012020111222221221122100121111111111a111111101111111011101111111100110111111010111011111111b102011212012221201100011121102202212212212201
11110101011100111012012112101121121222021222122221101001110a111010111011111111111110010111111010111111111111111110b212121022211021211111220122212221111211121122
10111111111110111111122122220110011211220012221121111011101a111111010111111101111110011111111111011001111111111111a011110111111111111111100111221212212022120022
11101111110111111012011012121021210212111121211021111011111a111111111111111101101111111110111101110111101111110000a111111111111101011011101101111220121112222122
10111111110111101111221011110221012222020221111220111101101a111101111111111111110110101111111111101111111020201221b121201220001121110111111111011212012101121122
10010011101111001111111101011111110111011101011111111111111a111101011101111101111011111101111111101111112221002111b222211221111221102211111111110122121100021020
11101110110101110110101111101111111111101110111111111111111a111101111011001111100111011111111111001111110112211101b121110011212021222210111110110112122112212121
11111101111110101111110111010111110111110010101111001011011a010101111101110101111111111110111111001110111100210002a121101101201111112011101011011111111111111111
11111011111111101101101111110011110111001111111111111010111a111111010011110111011111011111110110101111111100020220a221021211210012200101101111111111110111111111
10111111100111111011111101100110111111111101101111111111111a111111111111011111111110110111101111101101102111212210b221012021201011012211011011111111110011110111
aaaaaaaaaaaaaaaaaaaaaaaaaaaaaaaaaaaaaaaaaaaaaaaaaaaaaaaaaaaa111110101111111111001001001111111111111101111101122222b210211121222122222211110101111101011111111011
111100011011110110110101011111111011111110111011100110101111001011111111110011101101111111111011111010011122222211b211202100211222121101111111111011111110111110
110011110011111111011111111011101011111110111111011110111111110111111111011111111100011001111101111011112121122022b001012222211200222101110101111010111110111011
111100111011111111101111011011101111111011011101111111011100111011111111111011111110110111101111111111101122112120a122222020210121101111101111110111101100101110
011110011110111111111111110111011101110111111111110111101111111101110101110111111111111111011111010111012011110112b111200211222222212210111111111111101111110111
111111110101110110010111111011111010101111110011011111111111111111111110100101011111010110111111011111112121210122b022100022210112120211101111111100011111011111
111111111111111111111011101101110101111111110110111001100111110101101101011111111111110101101010111111011122110212b201021112121221110011111011110111111111111110
110111111101101111011011111011111100011111111110101110110111111111110101111111111111011111011011101111110121121111a011112220212101111010111111111111010011111110
111111001011111100110111111111011101111001011001111111111111110101111101111111111101001110111011010111102121212111a210021212112111112010110110111011101111110010
111001111101110111010110011111011111111011110111110111111111011010011111110010110111111111111101011111111220222212b012221111210212210111110111111011010101011111
111011000111011011101011111011110110111110111111111111011111111011100111111111111111111111101011011101001002021111a110221122122121212111110110010010011111111111
111101001111111111011101101111111010111101110010100111111111100111010111110100111111110111111111111101112112212211a110201121102211112201101111111011011111110101
011111111010110111111111111111110111011011110110111111111011111111110110110110110111111111101111111110102211101212b222012212022011112211111111111111111111110001
111111101011111101110010110111111111111111110101111110111111011101111101011101101111111111111111111111111211222211b122112122212221101210111110110111111101110001
111101110101011111111011001111110101111111010111111100111111011111110111101111011111101111101111111111111121100012b202120201121122002111111100010110111110111111
111111110111111011111111111111101111111111110101011101011111101001010111111111111111111111110111111111002222202210b121110022111212202011011111111111111100111111
101101011001101111111101011111010111111111111111011111110111011011110101111111011111111111001011111111112122102221a212221222100202122011111101111111100101111111
111111111111101111110111111111111111111111111111111111111111001001111111001111111111111111110111111110102212002202a010212110201222200201111101111111101111111101
011111111001111110111110101111010011111111111111111111110100101101001111111111011110111110011110111111112200222222a010002200021112221011011111111101111111111111
