(116,63)(100,48)(112,60)(54,5)(103,57)(13,150)(14,3)(100,127)(8,69)(109,110)
(13,13)(1,117)(14,14)(62,142)(0,4)(15,17)(29,154)(42,16)(89,145)(12,76)
(68,89)
(12,129)
(74,47)
(99,151)
(97,94)
(2,33)
(55,2)
(87,43)
11101111111111011100122112221221121122120020221211111110011111101111a111111101111111111111111111000111001000011110112111202212211121120122110101111110101a111110
10111111111101111112120112221110201122111221121011111111111101101011a101101111100011110111110111101111111101011111101111121021112221011221111122111110111a111101
10110111011111111101102101021011122121111020221111111111110001011111a111100111111110101101111111101111111110111111120122222122210101221221112221111100010a111111
aaaaaaaaaaaaaaaaaaaa222212101202212122222122121110111111110011111111a111110110100111111110111011110110101101111111020201021012121122212221022212111111111a011111
0101110111010111112a100111112211102221211102221210100001101111001111a111111111110111110011111011010100111111111011221111010211122010120121022122110101011a111011
1111011111111100111b201212211221011111111100012111011011101001111111a111011111111111011111111110111100111111111111122122212211121121221111122221111111111a111111
0101011111111011110a121122211122212002102101221111111100110111111100a110111101001111111111111011111010111110101111221122211212012222121112102210111111111a111110
1111011101011111112a121220221122112221221210021111111101011110011010a111111110111010110011110010111111100111011111111022202112121221120111220021111111111a101111
1010111110011100112b021210121122111122010110111011011111011111111111a111111110101111111111111011111111111101111011111221101111110202110122212200110011101a011100
1111011111111111012b220012222000112122210212200200110111101110111111a101110011111111111000111111111111111111111111211220012222111210122111122010111111111a101010
1111111110011111111b021122102110222120121202010201110010011110010111a001110111111100111111001110110111011011110101111021210122021020110102122112111111100a111111
1010101111111111111b121102210221221211211222110111001011111101111111a111111011111111111111111011111111111110110111111021110002111111211122021021111101111a111111
1011111111111111100b121010111220212212001122001111111111111111111111a101100111111110110111111110111111100100001110021200120110110200202021000122110111011a111111
0110101111101110111b012210222021112220122022122211111011111100111111a101100111101111111110101111010101111111011011110221202122111221112212102121111111111a101011
0101111011100111102a211000010111101111210111122011111111111111110100a111111111111101110111110100110111101101111110021121110012222122221122220021111111110a111111
1111101101110111011b211111012211200112221212011211111111101011010110a111110111111101011111111111111111110110011111200212202220122201111200111002111111101a111111
1011111111111110010a121201010222121011212012212111110111101101111110a111110110111111101011101111111011101111111111211111211012110211011110202022111111111a111111
1101100110111110010a111110001101011111110111011111101111100110101111a110111111110110011110011010101111101110111101111121111022202020222221012211011110111a111110
1111011011011110010a111111111001110111100110111011111111110100011101a011101111101111110000111111111111111111011111201112210222121021120211112100110111111a110111
1111111101111011011a111110011111111101111010111111111011110110111111a010011111110110111111111111001111111111110011101220202022100210011101122111111101111a011111
1100111101101111011a010110111011001111111011111111111110111111110110a111111111011110011100111110111011100101111111122221210111220222122122212000111101110a011111
1110111111111010110a111111111111101111011101110111111100111111111111a111011111111110111111111111111110111101000011112101220121201012212210120101111110110a011111
1110111111111101011a111111011101111111111001111110111111011111011111a011111111111111100111011111110011100100111101212021210222101121200122120121110011101a111110
0110111111011111111a011011110111100111101111001100110010110111011100a111111110000111111100111111111110111111110111201111111122212221122020212121110110011a111111
1111011111100111001a101101111111100111101111111111111111111111111000a011111110110011111111111111111110001101111011211220202221121100112220202012111111111a111111
1111110111111001110a110101111111111011110110111011101111111111010111a111111111111111111101011111000111101101111111101111220202202112220002222222110111111a101110
1111111111111111110a111111010111111010111111101111110111101011100111a111111111011111101100111111011101111110111111021101012211202122112112212000011111101a101100
1100111111111101111a111111011110100011111110110111111111011111111111a111111011111110011111111111101011111111111111111110111111111111110010010100111001101a111111
1111110011111111011a110011111111111111111111111011111101111111110111a111111000101101111111101111001111101111111111010111010111110011111011111011111101111a111101
0111001111001111101a111111110111101111111101111011101111111111111111a110110101011111111111111111111110101111111110111101111111111110111111101111111111111a111111
1111110111010011111a011111011111111111001110011111011011111111110101a111111111111111001111111101111111111110111011101111011111111111011111111111010111011a111111
1111111110111011111a111111100111111111001001111111111111110101011111a111111111011111111001101111001100111111111011111110111011111111101111111111110101110a111110
0111110111111110111a111111111011111101111101011111110111111111100110a111111111110111111101111111111001111011011111111111111111111101001011111101111111101a101111
0111111111010011100a111111111111111111010111001110110111111011111010a111011110101101111111111111111111111111111111111111011111011111101011111111100111111a110101
1001011111010011110a111111111000101011111111111111110111011111111100a101101111111111011011111111100111110110101100101111011111111011011111111101101111011a110011
1101011110101101111a101111111101111110111110011111111111101011110000a111111111111111010111011111111111111111111101111111101111111101111111111111011101101a111111
1111111111111111001a111110001111001011011100111110001111111111011011a110111111111111010111010011111111111111111111111010011111011111111101111111111011110a111011
1111111110111011101a111111101011111111011111111110001101010111101111a111100010111110110100101111011111111111111011111111101111111010100111111110010111111a111011
1111011111110101001a011011111011111010111111111111100110101111111111a111111110111110110111111101111111111111111111011101111111110111111110111011011111111a101110
1110110111110110111a111111111111011111110111101111101110100101111011a111111101111111000011111111101011111011111110111101111111111101111110110101111111111a001111
1211201122220022111a10110011aaaaaaaaaaaaaaaaaaaaaaaaaaaaaaaaaaaaaaaaa1001110101110111101aaaaaaaaaaaaaaaaaaaaa11111111111101111101111111111111111111011011a101010
1221222112211112211a01110000a11110111010101111111111111111111111001111110111110011111011a1101111100011111010a11111010110111111111101111111111101110111111a110110
2102211112101011110a11101000a11111011101001110111011111011011101100111111110011111010111a1011111111111111101a01110111111111110011100110110111111011110111a111111
2101212121211110111a01101011a11101111101111101001001111111111101111011111011100111111111a1111111111010111101a11110110100101111111110101011101111111011111a111001
2120222210121112111a11111011a10111111110110111011111111001111111101001110101111111111111a1110111111111111111a11111111111111000111111111101010001010011010a110111
2101211110120112111a11111111a00111110111111110111111111011111101011111010011001111111011a1110111111011110101a11101110111011111111111111110111001111111011a111111
1212212211211201101a00111111a11111111101001111111101111111010010111111011011111110111111a1110101111011111011a11111101111101101111100111101110101111111111a110110
1112201012110102110a11011101a11011111101111101001110111111011111001111100111011111111111a1111111111111101111a00110111111111101111101001110111011110101111a110111
1112212000221120111a11111111a11111010111111011111111110101111111010101101111111111101111a1111101101001101111a10111110011111011101111110111110110100101111a111111
0212101110200021111a00111111a11111111011111111100011111100101110111111111111111111101111a0110111101111110111a11000111011101110101111111111011111000110011a111111
1110111100111021200a11111111a11111001110111111011111111111111011110110111010110011111011a1101111110010101111a11111111111101111111111111111111111110111111a011000
2100112212121222211a01110111a11111111111101111111111111111011011100111101111110110111111a1111101110011111111a11111011111110111101111111111111101111001111a110111
1211220010110110110a11110111a00101110011101101010101111111100011101100110111111111110111a1111111100010101000a01111110111111111000111111111111111111111111a111111
2021111222121220001a11111110a11100101101101111111101111001111111111111111102220011212112a1221010122222221100a11101011111011111110111111011111111100111111a111010
1002212122122210111a11111100a10110101111111111111110010011001111111111111101111111200212b2012001001110111011a11101111111011111111111111011000111111111110a011111
0121110100112210211a10111111a11111111111111111111111111111111011010111111120021212211112b2022112010211201111a11111111111111111001101011011101110101011111a111111
1212110022112212201a11111011a00001101111111111111101111111111111111011111021112102212100a2022112112110021111a00111111111011111111111111111011101111111110a101110
0211112110012202111a01111101a11111100111100111101111111111111111100011111111111121111222b1210111211202211111a11100011011111011100011111111110110101111111a110101
0101112012212201201a10011010a10111111111011111111011101111101111001111111122202111211202b1112222112120111110a11100011011101111101110111111011111110111111a011111
1121112112200210211a11111111a01102110002012221220101212012211111100101111111122120000222b1121101122121121111a11111101111111111011111111101111101011110101a101110
0222200001101202201a11111111aaaaabbabbbababbbabbabaabbabbbbaaaaaaaaaa1111012021120111022a2021021102222111111a111010111101010111011101aaaaaaaaaaaaaaaaaaaaa111111
2222211202221011011a111101101111020212222222212112021211111110111011a1011001120211222121b2021121010211001110a111111111011100100001010a11111110101110011000010111
2201122210121101011a110111011111011221121211222121021110211200110001a1110121220201121002b1012221001122121110a110111011011111111110011a11010011111111101110111011
2102121222211112011a111111111111112211121110212102211111201021111111a1011010012110021201a1111121112221211110a010111010001111101011001a11110101111101111111011011
1110100102011212111a110110000011211221221111111210100101221102111111a1111111220201212211a0102221012022201111a101110110111101111111111a10111011011111111011111111
1221122020202121201a101111111111222022021021211221120222112211111111a1110112022222202221b0100122201022010101a111110001111111110111111a01111101110111001011111111
2111021102121212011a111011111011221111102002212212221121100110111111a1111020011220022111b0211111210112120111a101101111011111011011011a11111110010100111111111111
2111111120221222111a111110101101212211102111112120102021212112111010a0111112102220121012a1112121122222021111a011111111111111111111010a11110111111011100101001111
2121122222122100201a111110110111221112111200212001221221020121111001a1100122202022211120b2102212111112121111a111001111111111111001101a11111111111111111111111111
0212102020221120011a111110111111121001220212111102220221221020110101a0101112022212122020a2112221221122221110a011111111111111111011111a11111011111110011100011111
1111110111101111111a111111111110220022012211202210101022022010111110a1101111222110110122b2121220121022111110a111101011111111011111111a11011001111111111100111111
1111111111010111111a111110101111022210112212202020100222021100110111a1110021222020102210a2211100011221101110a111011111011000011111100a11110111111011111111101111
1010111011011111101a111110100112221112002202121201222222010101110011a0101102110102121102b1222112021021201111a111111011010011110111111a11111110001011011101101111
1011111111101011010a011100011120222122022221201202220200122002100110a1111002222121002112b0112021101112221010a001101111111111010011111a11011110111111111111111111
1111111011111101101a111110111222221002122012222102111202222111111111a1111101221101222121b1121020002222221110a111011110111111111101110a11111111101111111111110110
0111111101111111111a111111102212200012222212102122212022211210111101a1111121102022122111b2212012121221211111a111111111111111111100111a11001111111110101111111011
1010111111101110011a101110112110220222112222022222220202111022011111a1111011002111121110a2110211222102021011a110110111111011111111111a11110111011101111010111011
1110011111110101010a010111102202222000221202022202101120220220011111a1100021220111221021b2111011011112111111a010111111011001100110111a11101011101001111111101011
1111111111110010110a111101111122222212120222222221220002212212010101a1101121100101200222b1211221120012221111a110111101111101111111110a11001111111111100111111110
1111011100011111101a110110111112222201021200202222220022221012101100a1111011001122122112b1220102120101021111a111101011111011100111111a11111110100111111111110111
1110110011001111010a001100111102021212022212020222222202020211101111a1011122221210222121a2100220122221121111a101011110111110111111111a11111111110110111110011111
1110111010111011111a011101111022202220122201002222010202102220110111a1111122010112212111b2221001211122211101a111111111111111011111111a10110111111111111011011111
0111101011111111111a111110112211100122222212000012221222122122101011a1011121020101222020a2220022222221012122a111110111101010111111111a11111100111111111111101101
1101111111111101011a110111111110222202221222211222112222012112111110a1101100111222111222a0121121221001201101b111110011111111111011010a11111111111111111111111111
1111010101111111101a111111112212201022212022121222212222220221111101a1111111101121112102b1111001211121202222b011101111110111111101111a11222222101121220011112022
1110110111011111111a101101112111222222221222021220120002201121111111a1111011011222111221b1212222111020200122b101011111111100111111111a01221110202100022121122101
1111110111111111101a011101100210022220212022122212221222222110110101a1111111111122012212a0211020022101221211b011111111111010111110011a11200210002111212122122211
1100111110011111101a011110102121022210212100221012222211012201111111a1100101111021022101b1211122011222121122b111011111011111111011011a11121121210010222221222222
1111010111110111111a011111112021202022102222102222020201201111110111a0110101111121021202a1122221121100201112a111101111111111101111010a11221211122220022110021121
0011011101111111101a111110111211222122212221120120212112201111111110a1111111010211211111a2221000200022001221b111110111101111111111111a11022211221212202111202101
1101111111111110001a111011111121022222222112010002221100211101111111a1111111111221222101b2202110211112122112b011111111111111111111101a11200121210121201121112202
0111011110111101011a101001110011122111122110010212111111121111111011a0101101011002120211b1022122111111221012a111001101111111111111111a10202121200000120102211222
1111111100111110100a111111110101122122120211221111211222221101111101a1111011110212222220a1111221121022221122a111010011111101011011111a11121200221021200101212111
1110100110111111011a101011112022122022211021010111121122211101111111a1111111111201222221a2222112112120202110a011011110111111111011111a11210121222210222012102122
1110111111011111000a100111102221121201101110120022211011221111110111a1111110111120220110a1212122212102222211b011111110110111110111111a10002222220221112221211201
1011111110011010011a111101111222212202112211012001222221021110110011a0110011111221121212b2211002212211111202a111111011111111111101101a10221111222112120110101101
1110111101110111111a110011110022211112122122122121112111120001111111a1011111110201122122a0121121211021110212a111100111111101111111011a01221110212111111021222111
1011111111111111111a111111110121222202202222211010200222221111111111a1010111011101212210b2221120111022121101a110010110101111011111101a11021111122112221220202201
1111111111100011111a011111111212121100210221200212002212221111011011a1111111111222212121b0222211112122212000a111111110111111110110111a10112202121212122121222122
1111100111011111101a111111010122212121201212121201222121121111111111a1100011111122102011b2111022120220210201b011110111111001111111111a01120222111222112002211112
1101111011111101111a011011112222122210201112121212212111001111111000a1111011111121020222a1201120012211101111a101110111111111011101111a01011021212222112220111012
1110110011111101011a011111102202022212011110122122211122221111111101a1111111111111122122b2101221021111210212b111111111111111011111111a01222120201221211211121221
1111111111011111111a010111111011110011011011111101111111111111111111a1111111111202211210a2122122210021211110b111111101110101111101111a01110220212221021220212012
aaaaaaaaaaaaaaaaaaaa110111111101111111110111111111111111011111111101a1001010111112111012b2102021221222201201a110111001101111011111111a11012201222201122222201201
10101011111111111111101111010110101011111111111100101101110111110011a1001111001122211120a2101222212122202222a111001111111111010111111a01021222201112111102101221
00110011101101111101111110111111011111111110111111100111111001011111a0111101101121112022a1012220122202112022b110111011111110111111111a01221222220021122201212120
11110101111111001111011101111001111010111011111111111111101011111101a1101110111110222110a0222012222222111010b111010101111011111010111a01212210121211211222012102
11111111111111111110111101111111111110100110101111110110101101110111a1111111111211112011b1121011211120211100a111101111111111111111111a11011201020022021122121210
11111101110111111010111111111101001110111001111111101111111101111110a1111101001222211121b2121220212220121021b111111111111111111111111a11122221122112120221112222
01101111111111111100101111001111111111011011111011011111111111111111a1111111011211222212b2001120201202112212a110110111111111111101111a11212002200010211122210012
11111110111101011011111101111111111111111111111111010111101011110101a1101111101121102111b2022210220221101221b111111111011111111111111a11222112011220222112121000
11110101111111111111110011111110001110111110001011001011110111111111a1111111100121210111b1221010020220121020a111100110111101111101111a11101121220222112222121201
11110111111110110111111111100111111110101001001100011010001111111111a1110111110111101111a0110111011101111101a111111110110100111110000a11002201211212120100111220
11111110111011011111001110101111001011101110111001101111101111111101a1111111111111010101a1001111101111101001a111111111101001111011011a11221122221021122122211201
11001011111111111101111011111111101110011111111011101110111010101010a1111110101111111111a1011110011110111111a011111101111111100011111a10111111111111111101111001
01111101111101111111111111101110111111101111111010101111110010111111a1111110111111111111a0110111110111100011a101101111111111110001111a11011111111110010100010111
11111011110110100101110010111111111011111111111111111101110111111101a1101101111101110111a0101111111011100110a111101110111111110011111a11110111111110011111000111
01111111110111111111111110011011111111111110111111111111011110011001a0001111110011111111a1110111101011111111a101011010111011011101111a10100100111111101101101111
11111101011011100111111111111010111111111111011111111111011101111111a1011011111011110011a1111101011011111110a111011101100111100110110a11001011111111111111111110
11111110111111111111111111111011110001001111111111111011110101111111a1111111101101111011a1111111111011111011a111011111111101111111010a11111111111111111111111000
