(11,19)(115,54)(1,86)(14,21)(1,158)(118,111)(49,13)(112,97)(8,36)(102,107)
(8,152)(102,156)(114,54)(69,151)(21,9)(13,159)(3,157)(33,12)(109,136)(46,8)
(6,61)
(116,63)
(32,116)
(104,156)
(8,109)
(94,26)
(19,75)
(48,8)
11111011111110011010111110111011110101010110112011a22120211102212122111112221011110111111110111b102211022122222221122212111211110111111110aa11110111111111111a11
11011110101111011101101101101111111101110111110102b01201211200202201112021011111011101111111112b221221022211001021200122110011011111101111a111011111110110110a11
00111111111111111101001101011100111001111111010102b22112211121211110211202021111111110111101102b100121220022102021111121020211111101111111a110110111111111111a11
01110110110111101011111111111111111111011101112112b11210102011222102112111101111111111100111000b212220112211121212212211221111011010111111a011111011111011111a11
11101111111101110011001101101111011111011111101102a22122010001200222222222021112121100211111111b212212222121222011211221111211111011111100a011001111111111101a11
11111110110110111100000011111101111110010111111112b00220221202222221222222201210212222120211111b221120021212220001202211121111111110001110a110111111100101111a11
11010011111111000111111111111111110111111111010120a21212022222212221200222201011120210212211112b011021021002220101112221210211111101110111a111001101111101101a11
01100111110111111111111110111111111001101011102122b20101111011012000121211102012001021211211102b222021010222220212220101002011100011111111a011111110111011001a11
11011111111111111111110111111100111111110111111100a21011011222221212120220012121122112021011110a222110200212120222221202222011101111100110a111011101111111111a11
11111110111110111011110011111111110111101111112010b10212211221220222010212222101112111222211111a110111120211101101222121222211111111110111a100101111110111111a10
11111111111110111111111010111011001111111111110221a01112101012212222220202221102111222111211101a122121110221212220212101021101011111111101a111100111010111111a11
00111001111100101111111111111101111110111111111112b11222201112222222222100222212212001220210110a122101112021210212212222120111101111110110a111111111111111111a11
01011111011111111111110111111010001111111011011212a21010220120100002121022221012121120222111111a010111202102111122010000111211001101110111a011111111111111110a10
10011111111011111111111111001110111111111110111111a11200111222022000121102221011212211102211102b221121110002221210000220222211111111011111a111111111101101111a11
11111001111111111111111011111100111111111110112120a12121212112200211221002022101221210110211112a212211211121121221010122021011110110111011a111111111111111111a00
11111110110111010110111011011001101111111111101022b12000121122221202002222201012121020100111101a202122210002002020222111211211101110101111a111111111111111111a11
11111111111111001111111111111101011111100110112220a21111211222220221202121221200112022120111110b201211012212001020021002012201101110010011a111111101111111111a10
11111111111101111101111110111110110111101111101012a10211111000220201122212222101201101211210112b120220221222222202222012122200221121111101a100111111010111100a10
10111000110101111111111110101111110111111011112210a00220011021222002021222222112100012212111101b200111222002222001202222202112201211111111a001100111111011111a11
11111111110010111110111011111111111111101110011102a12210121211222201212222222212101212111201012a121222222222012222120222222220222010011101a111111011011111111a11
11111111011110111111111101111111111111111111012221b12120022121220022222202201220020200122010112b222112221222222212221110220200121100111110a111111111110111111a10
01111111111101111111101101001111111101111111011110a11111111112120102012221212220122121200111101a111012220211020222201012220102022201110101a111101011101001111a11
11101111111111110010101111111011111011101111111011a10111111001212111200121201201112110222110110b211112222202021010222222122200212211111011a111001101101011101a11
11101101011110011101101111010111111111111000111110a10111111122212212121212201220202120211111011a110111211121210111222121022122121011111110a111110111011011111a11
01111101111101101111110001111111111101111110111111a01111011100111021210211212010210121222211110a111012210111202110221222022021212211111100a111011011011110101a01
11101011111011101111110001110111101111101111011011a11110111022021120201122220212210110211111101a101112102121211222221212112122221221111111a111101101000101011a10
10111111111111111111111111111111101111111111111011a11111111111211110010012111112121011120210111a100112212111222100210202022021121121111011a111111111110111110a10
11111111101110111111111001101111111111011101011111a11111111112112222222220112212221021122211110a111012212112010122221222101021221211111111a101111011110110111a11
11111101011111101011111111111111110110111111111111a11110011121220111222122121211222020122211110a110111212211112122100122111201112211110011a110111110111111111a00
11111111101111110111011111111001110111111101111111a11111110112212221222202101112120002021111011a011102211110222202010122210011100111110111a110111111111111110a11
11111111111111100100110111110111110101101111110111a00101111122201021121221210212122111021211111a011112111011101121222211201101021001101111a011010110011111111a10
11110111111100101110110011110111011111111110111101a11111111121220111122021001211020210202201111a111111202122011221011022212112012110111101a111010010111101001a00
11111101101111111111111110001111010010111111111111a10111111112200001001212122000211211111111011a111012100222212122112121002022022121111110a111111111110110110a11
22211112010122211211120011111111111111111101111111a11011001120221011222111121111011212012201001a111110202211021220122022121111110021101010a111111111110011111a11
02010212212212112201201100111110011111010110111111a10011111110111111111101110111101111011111111a111110122021201221100202020102022101110111a101011111111110101a10
12222210211221221111222100111111111110111111111101a11110111111110101111110011111101101011010111a110112101021222202111221222112211221111111a111101100111111111a11
21112122212221022101111110111111111011110100110111a11111111011110010111011011110001110111110111a111111101122121212120120211112022111101111a101111101111111110a01
21201101222121122220102111111000101111111111101110a11110111111110011101111110111000111111101111a111111001221022222111202200222121211110111a110111101111010011a11
02211112101020011222111111111111011111011011010111a11111010101101101100111101111111011011110011a110112222121202112200201101121222121110011a111111001111011111a11
21111112121211221121212111111111111111011110101111a11110011111011111011111111001111111111111111a011112200222221221221021212211102121101110a010111111111111111a01
22102212212011122211120110110111010111110100011111a11111111100111111111111111111111111111110111a100112120011212000221111222120121111111100a011101111010111111a10
11112220020002112202212101111110011111111111111111a10111111101111110111111111011101011101111101a110101120020121212222221120222201221111011a110111111111111111a11
10211111211200212201112111110111111110111110010111a11111111111111111100111110000111111110111111a111102202220202111022102112012112200111111a111011101110111111a01
20100101022011121222212010111110011111001111111111a11101111111111010111111111110110111110001110a111100212021212112122122202022220101111011a110111110110111011a10
22222020020212010112211111100001101111011101111101a11111011111110111101111110111111111001111111a101112211211020202211122110222221221111111a111011111101111101a10
22111001211121212100121110101110111111011101010111a11011101111111111011111111000001110111010111a111012122201101111011021120122201221001111a111011101101001111a11
01221212112100212200111111111111011111111111100000a11101100101101101111111111110111011111111011a011012202102121121211122211112112101111110a111111111110101111a10
22211111022020222110222111111111111111110111001111a00111111010111011111111111111111111111111111a111111111111111111110111011111111111011111a111101111011011011a10
12100112122212022012112011011111110011111101111111a11111111110111111111111111011010111001010110a111111011111111111111111111111111111111011a111111111111111111a10
21121122222212111100221011101001111111111011100111a11111011111110011111111111100110001101110111a110111111010111111011111111111111101111111a111010111111101110a11
22022002201211011021221011101111011100101011111111a01111011110111101101011110100011011111111011a111111111101111111111011111111111001100011a111111111111011111a11
12220011122221210220111011101111111111110111010110a11110101111111111111111111111111011100111111a111011110001110101001111111111101111111111a001111110100110011a11
11222012000101101012221110111010101100101111111111a11111110111111111110000010011101111111111111a100111001111011000111111111111111111110111a111111011111101111a11
02120222202201001020011100101111011101101100111101a11110110001111010111101111111110111111011110a111111110011100111111111010001111111011111a111011111101011111a11
20111112202121220211112111011111111101110011111111a11101101010111110111111111111111111111111101a111011010111011101111111110111010110111110a101101010111101011a11
22121201102022210001101111111110111111010110011111a11111100111100111110111111011101011101111011a110101111111001111101011111011011111110110a110111111111110110a10
02101222102200112221121111111111110111110111101110a11110111111111111011111111011111101101111111a111110111011111101110111111111101100111111a001111111111111110a11
10022211121210221112200101111110110111111100110111a10110111111111110111111111011010111111011111a101111101111101101111101010010010111111111a110111111011011111a11
01121122010111110201101011111111111111110011111101a11101111110111011111111001010111011011101111a001011111011111111111101101111000111110110a111111001011111111a11
211020210120002111020101010111aaaaaaaaaaaaaaaaaaaaa10111111111111111111111111110111010111111111aaaaaaaaaaaaaaaaaaaaa0110111100101111111011a111111111100111111a11
121111212201112211121121101111a111111101111111111101111011010111111101111111110111111111111001011010111011010101111a1011111111111111111111a111110111111111111a01
122222210211212020212021111011a111101111111001111011111110111111111101110100111011011110011111011111011101101111111a1111010111110111111011a111101111011111111a11
120210022101222011121120111111a010111111101111011011110101111110111111101111111000111111100111111110101111001111111a1111101111110101111011a111110111111101111a11
100111111111111111101111011011a110111111111111010111011101111111110111111001100111111111111111111111111111111111101a1111011111110110111110a010111101101011011a11
011011101111111111111110111111a011111111111010110111111111111111101001011111111111110100011111101100110101111101110a1111111111111111101111a111110111111111011a11
111011111111111110110111110110a010111111111100101111111101111110110011111111101011110011111111111111111111011101111a0110111111111011110011a010110111111111111a00
111001111111111011111111111111a000101111001010001111111101111111111111101101111111111110111111111110100011111111011a0111110101111111011111a111110111111001011a11
111111011101110101111111111101a110101111111111111011011111111010110111100110101111101111101110111011111111111110110a0111111111111100011110a011111111111110111a11
110001111110101100111110110111a101011101001101111011111111110111011111111110111110010011111100111111111110111111111a1011111111111111000111a001110111111111110a11
110111011111111111111111111011a101111111111011110011110011111110111111111111111011111111011111110111101011111110011a0110101010111011101110a111011111110101101a11
101110101111111111101011111001a101011111111111111111111111111111111111101001101111111111101101111101110111111111111a1110111111110111111011a110111011111111101a11
111111111011101100101111111110a101111110111111111111111101011111110111110111011111111111111111101101111111110111111a0111111011110111111000a111111011111101111a11
111101111110111011101001011111a011111100101010110111011111110101011011101110111111111101111111011011111111111100111a1111101111111111001111a001111111101111111a11
111111010111111101011111111111a011100111111111111111111110011011101011010110111111110011001111011111010111111110111a1111011101010110111011a101110111111110111a11
111111111111101011010111110111a101110110011111011111101111111101011111111110111011110110111111111111110111101110110a0111101010111111100110a011111111110111001a11
010101110111101110101100111111a111011111111111111110010111111111111100101110111101111111111011101111111101111111111a1111110111000111111111a011111101111111110a11
110111111111011101011111111111a011101111111101010110111011111111011110101110111111111010111001111110110110111011011a1111011111111111111111a111111111110001111a11
111111011111111110110111111111a110111110011001111111101111001100011110101111110110111011111100111111111100110010111a1111111101110011111011a110011110111110110a11
111100101111110011111101111111a111100111011111110101111010111111110001111110111110110111001001111111111110010111101a0111111111101111111111a001110100111000101a01
111111101012222222201110211221a202121121211111111111111aaaaaaaaaaaaaaaaaaaaaaaaaaaaaaaaaaaaaaaaaaaaaaaaaaaaaaaaaaaaa1011011001111110011111a011101111111111110a01
111010101101120222111111221210b212112222011111111111110a1111110111101111110111011101111011101111111011111110111101111100011011011110111111a111111111011111111a11
111011101111122110220212111110b111121211211111010011111a1111111111111111111111111111101111110010111110111011101110101101111110111111111111a110111101001111110a11
111111110110102211021122100110b110101102111110111110110a1110111101011111111011111111110111011010111111011101111111001110111111111111011111a011101111011011111a11
100110101012210121221121211122b121211112011111111111111a0101111111101011111010011111111111111100110111110111111111111111101101111101111011a111001111100101111a11
110111111012202121222212121111a020122111211110111111111a1111111101010110101111111010111111111111011111111111111001111111111011011110010110a111111111101111010a11
100111111112122221011212022201a212121112211111101111101a1111111111111011110111100110111111111100101111011110100111110011110011111111111111a101011111010111011a11
101111111101002102010111212121b212222220210111111001111a1011111011111111011101011101111110111011011111101011110101100111111111011011010110a101111111010110101a11
111011101111212202212111211220a102221222111110001111111a1110101111111101010111010111111101111100110111111011111011111111110110101011110111a111101011101011111a10
110111111111112220112012111102b121221212111110110011111a1100111111111111111111111111111011111110111111111110111111111111011111111111111110a111111111111110111a00
100111101112122011100122102122a021101121201110111011101a0111010101011111011110111110101110111111111101101111111101111111111110011101110101a111212021221121002b12
011111111112102112102022110101b220110211211111011110111a1111101111111111111111110111001111110111111111110101111101111111101011111111011111a112121221212021111b22
101111111110212021021201221122b112022222100111111110110a1110111110011111110111011111111110100111110111110110110111011111111101111111111011a011112021220212011b20
101011111112222112221001122222a122021110111111011111111a1110111111111111111111111110100111001101101111111111110001111001011110100001001111a111211102022212010b22
101111111010002122121221202001a211121111211111001111111a1011111111111111100111111101010111111111101010110111111111011011101111110011111110a111112212212201211b10
011011111111011001222101020222b010121101200111011111101a1001111111111011101111001011111101111111111011111110011011111010111110111101111111a111011212211021002a12
111111111111222120002221210111b200122122011101100111101a1110011101111011111111011110011111011111111111111101111011111111011111111101111011a111210022210110121a01
111101101001122221221102221212b221212220211010011111111a1010111101111001111111111110111101111111111101111111111111111111111011110100111111a011121211011101210a11
111111011101121021211202112011b112111221211010111010110a1111111111111111110101111110110111111111111111110100011011111111100111101101111101a102022020102222222b12
111101111111022111121121110202b211221112200011111111100a1111111011101101101010110110111110101000111111111111111111111111111111001101111100a101222021220011120a12
111101011100222122220122212212b212111202211110111111111aaaaaaaaaaaaaaaaaaaaaaaaaaaaaaaaaaaaaaaaa110111011111111111110111011111111111011011a101221111221112120b20
101111111111100121100021121212b1012112111111111110111111110100011111111111110110101111101111010a1110111111111011111111aaaaaaaaaaaaaaaaaaaaa111201110110201201a10
111111101112220102202120121222b2000120020111111021211002020122221020111222222211111111101101110a1110111111101111011110a10011111110111111111111011220220221211a21
111011011112201122000022211201a0110211122011111121022111221211221020222110112110111111110011011a1011011110111101010110a11111111111111011001111212222221121122b21
011010110111021210122221122201b1122022102111111100022222211022121111210200210211110011111111111a1011110101111111111111a10111101111111111110112020202102020022a21
111111101011222201002001002211a2022212111010111112222100121202222220121120222111101110111111111a1011010111111111011111a10110111111111111111000101111121212222a20
111101101110220111222121212121b2222021212111010122121221200222121210000201202011111111111101111a1110111111110110111111a11011011100111110111101222212112210221a21
011111011110121211220210211110b1000202021011110111112220211201202101010111222111111111111001111a0101111111111110111101a11111111110101011111111120112112202122a11
011101111110111110022121211222a1221122012111111111111201221222202222022111021211010101110110111a1110011111111111110011a11011110001111011011112012110201011001a20
110111111110220121202112000221a1111201101111011100022220222211111220221222220011101110110110101a0111111101011111111111a10111111001111111111102120112212011212b02
111111111111111110111111111110a1111111111111111011212211022201211110212210222111111111100111101a0101111110101111101111a11111101010101111111111101011112212211a00
111111110101111101111111111111a1111111111111111111222222111201212222011111211011001111111111101a1111001011111111001111a10111111111011111110112121011022222021b12
111111111111110110111110111101a0111111101111011112222211221021110212110101221111011111011111101a1111111110110111111110a11110111111011100111112001212122102221b10
110111110111110010011111111111a1011111100111111111012200120201100222201122120201111111101111110a0111101011011111111111a11111111111111111011101222000112210211a10
000111010111110111011101111111a1101011111011011011221002021210211021212220211211011111011110011a0111110111110111111111a00011111111110110101010202112120111112b11
111110111111111111111110011111a1111111111011111111101221022211201111122021102201111011011111100a1111111111111100111110a11011111101111111011101011011111001121a20
111111011111011011111101101110a1111111111111111020200211212011121211210122221111011010111101111a0111111100010001111111a11111110100111110111110111210202222021b12
111110110001111111101111101111a1111111111011011102010101211112011112211212102111111011111111111a1111101101110111110111a11111111101100101011011122110111011122b01
111111110011111100110111101101a1111111111111011122220212011101220220112111202111111111111001001a1101111110110111011110a11111010111111111111111121022122111102b12
110111111111011001100101010111a1111111110111111120112020222102212210101110112211110011111101111a1101111110101101101111a11111111110111111111100211121212111112b02
111111101111101010111111111011a1111111110111111121121221211121111222002020212011011111111110100a1111111111011111000111a11111010111111111101111110111111111011aa1
