(3,72)(116,55)(114,153)(16,53)(4,148)(2,18)(11,149)(109,137)(17,17)(38,155)
(116,49)(66,153)(56,8)(102,133)(114,13)(85,147)(117,155)(7,149)(1,156)(117,77)
(61,148)
(25,1)
(53,8)
(83,69)
(66,152)
(49,16)
(45,142)
(118,57)
011110111001010001100101111111111111111a11111a101110111111001111111111111a111111111111111110111011111110101111111a0110011111111111101111111011011111111110101111
100000111011111111111111111001110110100a11101a011000110111111111110101111a111111111111111111111111101011001111111a1111111110111011100111111101101111111111111111
111111111111111011111111111111111110000a00110a111111101111111101111110101a111111011111101111111101101111111111101a0111111111110111111011011111111111110010111111
111111011111111111111011111111111011011a11111a111011111111110111011111111a001111111111111001111111111111111111001a0111111110001110101111101111111101010111110111
111111111110101111110101111110010111111a11111a011101111111111101111011100a111111111101001111111111111111101110011a0111011111111111111100111101111111110111100111
111111111010111111000110111111111010011a11111a001110111101010111111111101a111110111100101110101111111011111111111a1100010110101011111111111101011110111111111111
100111111101111111111110111111101111111a11110a111111111110001111011111110a111111110111101111111101111011111111111a0110111111111101011000110111110011111100011011
101111111110111111011111011110101011011a11111a111101111111110111110111011a111111110111111111100101111111110011111a1111111101111101101111111111110111011111111110
101111111111111111111011111011111111011a10111a111011111111010111101011111a011111111111101111111111111111111011111a0111011110111001111111010111011111001111110111
111100111111111101110010011111111110101a11111a111011110111011111110111111a010011101110111011010111111111011111110a1111111011011111011110011110101111011111101111
211111201220222211011011111111111011101a01001a110111111011011010111011010a001110111011110111111111011110111110111a1011111101111010111110111011111111111111111111
221112110101201111111011111101110111101a00110a101110110111011111111111101a110101110111110110101111100011111111111a1001101101110101111101111101111111011110111101
221221202112022211111111111110111111011a11100a111101111111111111011110111a010111111111111111111011110000101111111a1010111111110110111011111010111111011101111110
121122112022121111111110111111111011111a10111a011101111111111111111111011a111111011011101110111111111011111011111a1111111110011111011111110101111001011111111110
202211212221202111010100111101111001001a11111a010111111011111111111011111a111111111101111010111111011111110011111a1111100110110011101101110111110111111101110111
222011222110212111111111111111101111111a11111a111110010101011111111111111a011111111111111010111110111101111111111a1011011101111011111111111111110101110101110111
101110211012021211101111101101111111110a01011a111011111111101111101011111a111111111111110111111011110111101111110a0101111101111011001111110110111111011110011110
102220112111112211100111111110111111011a01011a111011110101111111110111111a111111111100111111111110011101110011101a0101111111101111010111111101010111111101101111
112122210121020111111101011111111101111a11011a101111101100011100111111011a111110111111011111111110011111111111111a1111001111100110110111111111111000011111110111
022210121112021211011101111100111111111a11111a111010000111111110111011011a1110110111111010111aaaaaaaaaaaaaaaaaaaaa1110110001111011111111011011111111101001111111
122121101202010111111110111101111111111a10111a010111111111011111011110011a1111111101110101111a011111011101101101111101011011111101111100101111101101111101101000
221021221212220211011110111111111101111a11110a111111101111011111111000100a1111111101111111111a110111111101111111111000011111111110011111111111111011111110111111
101101122010011011011111111111111110011a10111a011111111111111111100111111a1111111111011111011a001110111110111101111011010111111111101110111110101111011111111111
211212221222011211001110110111111111001a11011a110010110011111101111110111a1111111100111101111a110111111011111111111110111111101010111111101111111101110111111011
021212112201211111110111110110111111111a11110a101110111011011011111111111a1111110110111111111a001111111111111111111111111111110111101101011101111110111110110011
021211101221211211111111110101111011101a01100a101110101111110110101110101a1110110101100111011a111101001001111110101111101111111111111111101111000110111011111111
201210212102000211111010101010101011010a01111a110010111111110111001111110a1111110110111101111a111011110111111011111111110110001111110111111100111011111111000111
011222201222212111010111101101111011000a11111a110110101100111011011110111a1111101011111010111a111111011111010110111111110001110111110111011011111110011011111111
102111121221000111111110101110111111111a10111a111111110011111110111111101a1111111101110101110a111111111111011111110111101111101111101111111111111101111101111111
111121102011110011011111001011111011010a11100a111111111101101101110111111a0111111111011011111a111111110110111111111111111011011111111101111011111111111010111111
020222212210122011111111111111111011111a11101a111111011111111111101001101a1110001001011010010a101111111100111101011111011101111012211120011110110001210212110111
212211122220011210110111111111111111111a11111a110101101111011011111011001a1111111111101111111a111111111110011111111110111111011121112012111112112122222212112111
122020111101111111111111111111111111101a10111a111111111111110111010011111a1100111011111111101a110101111111101100110111110110011212221111220202112121122222101111
022110210100212101111111101111111100101a00101a101111010111111010101111111a1011111111111110111a111111110101111111110111100101111122111110222112122201120222121110
122222221220212111210021101110211100111a00011a111101111111111111011111110a1011111010011111111a101111110101110111111101010111111122111022222222222201122021222111
221122201221022201010222212210111111100a11110a011110111111110111111010111a0111111011111111101a111111111111111100111111010011111211121122211121111110200221210111
102001122212222212211202202101210000111a11111a101011100111111111011111111a1111111111111111111a111111101110111010110101110101101201121201110110012022202120210111
121212112212021221200122001222101111000a11110a111101111011110111111111110a1110111110110101110a110011110111111111101111111101111202101202111011221211122021221111
220200222222022212212202100222211100111a11111a100111101101111111111110111a0111111111111111111a000110111111101111111111010111101121122201221222212211020220111111
222212202020222221020221111022211111101a01011a111000111111111011110110110aaaaaaaaaaaaaaaaaaaaa111001111111011111111111111111111110221100220111210112112222022111
122221120221222222222001211212111111111a11111a101110101101111011111001111001100111101111110111111111001111111110011011011111111102222111002110221212111022101011
222210012221020120202221121211100111111a11111a111101111111111111110110011100000000101111010101000011111010011111101100111011111012221102120111111112121200211111
202100221122220020212122201202211111111a11010a111111111111111111111111111111101111111111101111101111001111010110111011111110111111110002201010211102122200102101
000210221222220222112001112221101011101a01111a111111010111111111111111111100111110011001110111111110aaaaaaaaaaaaaaaaaaaaaaaaaaabaabbaabababbabbaaabbbbaaabbabaaa
122211220202210121222222110011010111111a11111a101010111111110011111011100111111111111111110111100011a11101111011101111110111111012120012101222211202120021120001
002022021122220001220221011201111111011a11111a111111110111111111111111111101111111111110010101110101a11111110001111111111111101200222010102110121202111212102100
122021220022212212022222112022211110111a01111a011111111011111111111011111111111111111111011111111110a01110010110011001111100111220102122122222222220202221222200
122221120220210222212211221112111101111a01111a111111010111111110011100111101111111111111111111100011a11001111011111111111011111222001120222102222202102222222121
220112222222211021022020221122101111111a11011a111111100111111010111111111111111111011011111111011110a10111101111111111110111101101111222022202201222121222022022
102102222222012201020001022122111111100a10111a101111111010101111111101111101101111111111011001101011a11111011111111101101101110201011220101122120220221222220121
122222010220102220120222221112210111111a11111a011100111111110011111111001111111111111100111111111111a10111111110111110111101111122010111211221122020112021100112
022121201222112022200211122022211110111a10011a111111111111111101110111111111111010111111111111011011a11111111111010111111111111201221122212221222222222200202222
120222002022222022222222111102111111011a11101a011111111101111111010111110010111111110111101101111110a11111011100111001111011100201020120022221202022222120222212
200222000112002010212221220211211111111a11110a111111001011011111111110110111011111111011111110110111a10011111111110111111111111111221221022022222221200202222220
211221202212002110222211121110211111111a11111a100011100111111010111111111101101111111111111111110110a11111111111111111101111111111110021022222222202222202202021
120201221222222222211012212220211011111a11011a111100111111011111110101111110111101101111101111111111a11111111111111101111111111221110212122121212202201222222200
002212222021101100222122112222101111011a11111a111111111101111011011111011111111111110011111111011101a11010111101011111110101101212202122122022222220022222102022
220200101102220222221020111212210101111a11111a111101011111111111110011101011111100111111111111111111a11111110100111101110011011222122010122220220220202220022222
120220202222112122002221122202110111101a11100a011111011110111111111101011011010010111111111011111011a01110011111111111110111111211112202200222012120222022222222
022222122222121100022211111111000101111a11101a101111111101111111111111111111111111111100111110011011a11111101110110001111111111021110222221222222222222212222021
121210120222200220201222201212211111110a11111a111111110110111011011111001111111110111111111111011110a10111101101011001110111111011110102111110222222212220022222
102012010121022022220021212002210111111a11111a111011111011111101110101011110110110111111111001111101a11111011101110111111111111101111201022020011020122212222002
120020222212220002221221212011111110111a10111a111111101010111010100111111101111111111111111111111100a11101111101110111101111100101111201012222122222022221021222
222202122222220212222212212220011111011a10111a10111011111111aaaaaaaaaaaaaaaaaaaaaaaaaaaaaaaaaaaaaaaaa11101111111111111111101011011111212120220220221202101201121
021122202120212200210221001011111101110a00111a11010111111111a101111001111000011011001111000111101101111111111001100111111111111111111100022022212222112212222222
111222120022112202112201111110011110101a11111a01111011111101a111111111111110110111111111111100011011111111111101101011011111111011101022120020202022212122212022
212111200211122100211211011111111101011a11110a10011111111111a101111111110111111101011101111111110111101111111111110111111100101011110002110222212202202022102212
002112012210120222221220110111111111111a01101a01111011111101a111111001010101111011111111011111100111111011011111111111110000111111101012212202201021222222122222
111111111111111111011110110111111110110a11111a11011110012211b202202122222212211011201111111111111111011110101111001111111111101111110022222220020202210220122211
111111111101111111101111111111111101111a01111a11011111210122b100202200121221222202101111110101111110111111100111111111111111111100011122121222212222212101221010
111011011111111101101111111110011111101a11111a11010111120222a211122121111122112102211111101111111110111111011111111111011110111111111022202111221202202122200012
101011111110111111110111110011000001111a11110a10111101120212b012021021211211211111121111111010111111111111101111101111110011110111110122210202122222122202122222
011100011111010100110111111111111011101a11110a11111010110220a222222120222112021212221111101111111101101011111001111111111001111101011022121020222222201102121211
111111101011111111111111111101111011011a11111a11101111212222a121101121021011102201121111111111111101111111111011001111001110111101111211120212122021022210222220
111011111111100111011011111111111110111a11111a11111101010102b022102101221202220202221110111111111111110111111101111011111111111111111220020222200210202020222210
011011110010111111111001010111011111111a11111a01111101221011b111121021021201121121221110110111011111111111101111111101101000111111111112101212200212200121002101
111111111111111111011101110111111111011a11111a10101111211122b222021012112212111201201101110011010111101110111111111111111111111110100111112022121112222102210022
110110111101111000011111111111101011111a11011a10101111102121b221222010110202021212121111101100111101100110111111101111001111111111110111110212101221211220011012
111111111111111100101110011111111110000a11111a11101101111022a202211222122120221102111111101111010111111111111000011110111111111111001011121222222111221211212112
111110111101111111101111011010101111111a11111a11111111220002b020221102112101101021011111110111111110011110111110111101111111111111111111110112212112121112111211
111110111111111111111111111110011111111a11111a11110011022120a121220121222121100210110011111111101111110111111111111111111011111110111111101110200222212222011201
111111111111111111111111011111011111110a10001a11111010221010b121112101212120201220211111111101110100111111111111111111110111111101111111111011111100101101111111
110101110111111111101101111101111101111a11011a10110011212220a212111211211202112102201111011011001111111011101101111111111111101001101111011011111011010111111111
111111111111001111100110111101010111111a01101a11101111011212bababbbaaababbbbabaaa1211111001111011111111111011101111000101111111110111111101111010111111111101111
111011111111111011011111111110110001111a01110a0011011112022101122012121122010022b2220111111110011100101111011111111111111100111101111110100111011101100111111111
110111111011111111111110111110011001111a11111a1111111122220212221222202001222212b2021111111111111011111101111010011111111101100111111111100011011011101110101111
111101111111101101100011111111101111111a10110a0100111122210122112201211220001211a1121011111111011101111111111111111100111111111110111111111111111111111111111011
111110110001111010101111110111111111101a11100a1111111111212111012112111210011110b2221110011110011111001111101111101001111111111111111011011011111111111110111111
101111110111111011100111011101110111111a11111a1111001021111220211111202120212121b1200111111111110110101111011110111111111101110111101011111011111101111111011011
011011001001111011101111110111111110111a11110a1101101002212001001112121221222212a1211110111100110011111011111011011110011101111111101011110110111111110111111010
111111101011011101111110111101011111111a01110a1011111121022020221221122210012020b0111111101111111111111111001111111110111010110111111111011111011101111111110111
110011111111111010111101111011111111111a10111a0100010011022120221111102212222010b2111100111111110101101011110011111111111111111011111010110011111011111111111110
110110110111011111101011111110111111000a10111a1011011112121101121022111122122110b1111110011100011010101011111111111111111110101111111111111011011111111111111111
111011111111111101011101111110111111111a11111a1010111102112202221110201022112212b2011111111101101011110111011011111111100110111111111111111011101110111111111111
100111111111101100011110111111111100111a10111a1011111021221201111021200220210212b2111111111111111111111111111011111101111011111111011111011111111101100111111111
111101011011110101111011111011111111011a11111a1111111100221220111121022001101202a1021111110111101111111101011111111111011101111101111110001111010011111111111111
111111011010110111110111101011111111011a00110a1101111122121111111121022211022022a1121110111101111101011110011101101010110111111111111110111101111111001010011111
101111101110110111111111111011111111111a11110a1100010100122220021212011122222111a1201111110110110111011111111101011110010100111111111111110011001110101111111100
111101111000111001111101111111111111110a11111a1111111101110010111001111111111011a0111110111111101101111111111110101111011101111110111111101111111101111111110111
100101111111111110101111111100111110111a11111a1110111111111011111111111011101111a1011111111101111111111011111011011111011101011010111111111111111110100110011111
111111101111011110111111111011111011101a01110a1100110111100110000111110111110110a1111101111111111111010110111111111111111101001111111101111010110111111111111101
101111101111111001111111101001111111010a11011a1111111111101111010111101111111111a1111001100011111110111101100111101111100111101111101110011111011111101011111111
010111111111110111110101111011110111010a00110a1111111111101111111101011101110111a1111111001111111001111111111111111011100111111111111111010111111111110100111110
111011011111111011110111111111011111011a11022b1022102022101212010110220111101110a0111111101111100110111111110110110110110110011111111111111111111111110110011011
111011101111011101111111001101111101100a11221a2221211111222110112222112211111111a1111111101111111101110111111111101011111111111111111111001111111110111110101111
111010011111110111111110011101101101110a11121a2212220121122121121111120111010110a1111111110011011100110100111111111111100110001111101011111111111111110111111111
111111101111111111111110100111111111111a11111a0010110022111222012212101001111110a0111111111111011111111111111101111111110101111111111100111101101111011111111111
111111001111011111111110101101110011111a11012b0122000211220121210010120001011110a1111011111111111111111110111001111011111111011101110101011111111111101010111111
aaaaaaaaaaaaaaaaaaaaaaaaaaaaaaaaaaaaaaaa11012b1212120122022011101122121201111111a0111110111111101111101111111101111111111111111111111100111110101111010111111111
111110011111111111111100101110111110110111212a1202112212022121112221221011101110a1111111011010111111001111011111101111101011110110111111111111001101111100111101
111011011101001111111111111111011111101111010a0211222210201111120201211201111111a1111111111111111001111111110111110111110110111011111111111010111111111111101111
101111111011101111111110101111101011111111221b1121221221222201012001120111111011a1111011001111111111010101111101110111111011111111111110011111110111111111111011
111111100001111110111101101101111100011111000a1100021122021200121212021011101110a1111111111101011110110111110011110111111111110111001110100111111111111111111110
111111101111101111101111101111111111111111121a1122011120022101222011121011011011a0001111111011111110101110111111011111111011110011111101101111111111101110111111
111011110001110111111111101111101111111111020b2222210220201212202201020211101010a1111110111110111111101011111111110110110101111111111011111101110101011101111111
111101110111111111111011111111001110101111212a2101012212212011111120212111011111a1111110111111111011111111111111011011011011110001101101111110111111111111011111
011101100111011111111001111111110111111111212b1222210222122102222202022111101110a0110101111110111111011011100111111110001011101001110111111101111110111110111000
111110111110111011111101001001101111111111220a2021101202120121201112112211111101a1011010101111111101110101111111111101111110101111111100111011110110110111111011
110111111111101111100110111111111111101111112a1101000120121022222212112111111011a1101101111001011101111111111011111110101111011111111111010111111111111011111111
111111101011111110111111101111110111111111021a0212120111111211111221211211111111a1011110111011111111101111111111111110111111111110011111111110111111011110111111
