(99,71)(3,120)(54,155)(78,154)(107,42)(62,155)(104,28)(11,53)(113,142)(118,41)
(2,154)(72,8)(5,2)(5,78)(6,152)(64,1)(37,150)(13,153)(63,16)(111,148)
(81,116)
(18,93)
(39,75)
(58,12)
(0,130)
(96,14)
(65,71)
(3,76)
011111100111111011111111111110111111001a111111111111111111111011122210211b21210212112211210101111111111100111111111110212121122012012221220012221111111011101100
111111110111011110111010111111111101011a101111111011111111110222011111100b10201112202121122111011111101110111111001202100011212110201211021102210111111110111011
111101011111101111111011000011111111111a111111111110110111111200212011220a11101122222100220011011111111110111111111210122102211212111222111022002010011111110111
101111111110111111111111111110101001011a111011111111111101101021011120022b22022200220202220222121212221020221111111212122122120212221001220122012111111101101111
111110100111011111111111111001111101101a111111111010111110011121122112221b12201222222212210102120111202102221110111211122001001202211211020111211111011111011111
111011111100111111100011010101111101110a111101111111111111110012120120221a20112021222121012122212121200121121111111010221002120100210111211021122100111111111111
110110001111101110111111101110111111101a110101011111111011010121112112102a11122212221201222221110001001122111111100211111221111200112110202111111010111110111111
110111111000111110111111110111101101111a111111011111111011111112211211111b00022222122122202222122002010222021111111111212111112112212211102222211111101011111111
011011111110110011011111111000110111010a111111111101111111111202220212121b21122212201222122011122201211211111111111010222021120221110101202201121111101111111011
110111111011111011101011111111111111111a111110110111010111101122112102121b22122222222222122122121112121122121111101011010122012102011110010201221011101101101111
111111111100110111110110111101111111111a111111111010111111101110202222221b21210222221222222112120212211102211111111100021212122221001010101212221110011010011111
111111110101110111101111111101011011011a111011110101111010111021202110122a12102210221121202222202221201112211110111011011221201112111022212012211110101110111101
110111010110110011111101111111011111111a100101111111111111101112202212221b22022212122202211221211201021012021111111222221221122120111102210011021001101111111111
101101111101101111111110100111111111111a110011001111110111110222222101222b11212010221222221101012222201220111111111210110111221211122122220121222110101111111111
110110101111111101111111001111111011111a111011110110111111111120122011222a11212121120222122222222221022221111101111101200112212122220210021211011101111011111111
111101110111110110011011011111110000111a010111111111111110101212120212100b12002002222120022101222221120211021110111111111111101111111111111101011110011111111110
111111011111011111101111110110111111111a101000111101111111111021021121112b11100210012002211101122021021020220110111111110110111111111111001111010110011111111111
111010111111101000101111110101111111101a111110011111111011111122112202111b12022021211002201011112121112001110111111010111111101111111001111101111011011111111100
111111100111111111111011111111111101111a111111010111111101111011010101110a11102210210022121101221121110211210111111011111011101110110111111100111111011101101111
111100011111111111111111011111111010111a111111111111111011101111111000111a11112112212121111121122221100111221000111111011111101111111011111111111110100110111111
111011111111111110101111111111111111111a111111101101111111010110011110111a01112200122120011222202122101212201100110111101110010111111111111101011001111111111011
001101111111110111101111111011111111010a111111110011100111111110100110110a10112122111211122000121010220100010111111111100111111111100111001010111111111111100011
101111111101111001011011111101111110010a011111101111111111111001011101110a11112222111021101110212001212121120111111001111001010111111111110111011011101101111110
111111101101111110011111111111111011111a101111011000111111111111111101111a11111111112201101110202212111021021110111011111111111110111111101111111111001010111111
111110111111011011010111101111111010101a111110101110101101111120111112121b12111112222222121122120121000021211111110110110110110111111110111111111111011111111001
111111101111111011111111111111110011011a111111111001011111111212220112111a20120212020002222212121212111210011111011011111111011111011011110011110111111111101111
111110111110111001111111011111111111111a101110110111111111111222122010110a12222202111212222020202010221120121011111111111000111011110100111100111101110110111101
101111111111110111111011111111110111111a011111111100110101112111202011002a21121222220222221222012202222121211110001110110111111111001111110111111111111010011101
111110010111111111111101100111111111010a111111110011100101111100001200021a12120222122221202010220210012222120101111111111011101011101011110101101111100111011111
111011111110111111110011111111111111111a111010111111111011112121021011011b12100122020221122221211200110011121101101011111111111111111111111111111111101111001001
001111011111101100111111111011110111111a100110111111111011112121111212222b22212212222021200122222121111111221011100111010111111111111101101111011111111011110011
111111111011111111001110111010111111011a011101111111111111111221021111021a02110122012011120100100120121201101111101011110101101011111011111011001111111111110111
111111011111110111101011111111111101111a111111110011101111011222112102212b22222122220222020201121120021012121111111111111111111111111110111011111110011111000111
111011101111011110010110001011110111111a101111111111111111011121122112112b10122221101111201111011111100111011111111111111111010011111111111111010111011101111101
101101111010111101110111101111101110011a111101101110111111111212220021221b01212212211212111111111110111111111010111111111101110111101111111111111101101111111111
111111111011111011111111111111101101111a101110111111110111112121101111221a22102010200111111101110011111010111111001111110011110001111110111111111111111111111111
111011111111110111111011111101111111111a111101111111110111111211012100121b12022021221012121111110101111111111111101111111101111111101111011111111100110101101111
111111111111101111111111011111111111111a111101110111111111111022221210201a11120122122121211111110111110101101111101111111111110101110111111111111111111101111110
010111110011100111101101111110111011111a111111011111111111110211201201021a11212222221101111101111110111101011100110110111111110101111001101111101111111111111001
111110111111111011111111110111111101100a111111111111111111112211110120020abaababbbbbaaaabbaaaaaaaaaaaaaaaaaaaaaaaaaaaaaaaaaaaaaaaaaaaaaaaaaaaaaaaaaaaaaaaaaaaaaa
010111111111111010111111111111101101111a111111101111011111102120120012101210112221122100021111111111111111011111111111101011111111111111110111110001111111111001
111111111010110111111110111110101110111a110111111111101101111011111212110102211012121122111111111111101010111111111111111111100111101001111110110111111111110111
011111111101111111011101111110111111011a111101111111110111111220011102200211112211210210211111111111101011111111010111111111111111111101111111111111111111100111
111120020211102011210212222101100011110a001111111111100111111011201111202021211221200121121111111100110111111111011101001011111101101001101111010011111101101111
121110110212101121222221021111111111101a111100101011110001112101112221212102211121221112211111010111111011110111101111111110111110111111011111111110110111110010
221110222110022212221222222111111110111a101111111100010110111011222101111120111102111201100110011111111110111111101110110101111101011111111011100111100111111110
002212111022212010102122010101101101100a111010110011111100111111022222111221220201212201021100111111111111110111011111101010111101111111110111101110111011111111
122210111111210112211121220110110011111a11011111111001101101baabababbababbbabbaabaaabbbbabaaaaaaaaaaaaaaaaaaaaaaaaaaaaaaaaaaaaaaaaaaaaaaaaaaaaaaaaaaaaaaaaaaaaaa
111201012211011122112122221110101111111a11110101010110100111a012012121100222211112011020111000111101111110101111110111110111111111101111111111110111101110110111
012121212212012110202121012100011110111a10010111101111111101a111111202120221200021221120111111010111111101111111111100111101111111100111101111111111111011111111
102111201121002121221111120111111111101a11111011100111011111b202211120222222120202222101211111011111111111111111111101111011111101110111011110111111111001111100
102120122212012022120212221110111111111a01111110111011111101a221022201220122222221002222121111111111111011111111111111111111111110111011011001110101111111111110
212220021111111212210222202101011101111a11111101111111012012a222101222201012222202212102221101101111110101111111101101111111111100111100101111010111111111111011
211101211100121110120201222111111110101a11111011110101011122b020122011122222222222222101221011111100100111111101111111110011111010111101011110111111111111111100
221022100110020120122121222111111111111a11111111111101111002b102111122022211110101211201011111101111101101101011111111111111100111011111111111110011101111111111
111222110221112121211120112111111111111a11111110101011112211a111220122220210112101222210111111011011011110111111110111111011111111111101111111011110111111111101
221112012102112222112121021110110111110a11111111101111112201b211202112020220112100210211011111101010111111111111110111101110111111111101111101111011110111111011
212201212112111022110201112011111011111a10101111101001100121a121120112222111111220001011010110100111111111101111101111111111101101111111011011111111110110111111
211122222112121210100222202111111011101a11111011101100011222b001202120112111222220022211100111111101101111110111101111110011111110110000111111111101111111101111
002121020211111222222201222110111111111a11111001110111111101b022202200121110000212111201110101101101111111111111010011111010101001110111111111111100111011111001
122010211112011102122111212111111111100a11110101010111110100b122102010120011122222122010101011111100111010111011110111111011111111111001111111101111111111111101
221211212012122111202121101101111111111a11111111011110111011b122222201122002120210222211100101111111011111101111011110111011101101111101110111011010111011100111
201110112202000221202212122001111111111a11111110111111111222a121100021220211121221222211110101111111111111111011010101111101101110110110111110010111011100011111
210021020021102211202122221101110010011a10101111101111112101b101221121110121201001112111111111111111110111111101111101101010111101111110110011111110101111111111
221212110222211100220222121111101110111a00010111111111111021b222020122011201220112122110111101101011111010011111111101011111110100111111111111011111011111111011
121220121222011120122222202110111111101a10101111110111112210a222222202222122212211200111110001101111111101101111111011010110111111011110111110111111111111011110
102120212100101111221200212110011111111a11111111111011112212b122120012001122220221001111011110110011121021212112022212002112000212110101111101011111111111011111
202100212122112202112201212111010101111a01011111100111110110bbbbbbaaaabbbbbbbaaaaaaaaaaaaaaaaaaaaaaaaabaaabababbababbbbabbaaaabaabaaaaaaaaaaaaaaaaaaaaaaaaaaaaaa
001012121220112211122120222110110111111a111111100101111121122121212101112012221020202211111100111011011200222021022112100221110102211111111111011101111111111111
112210211121200012122222202011111111110a111101111111011101221002111020201102221010121201011111110110122111121122211201102022020012201001101011110111010111011111
112211220001212221210012222111100111101a110110111111011121212111012110112020122222022211010111110110111002102121020122102022221212010111101111110111011111101010
212011212122212221102102212111111001101a111110110111011112020222221222211211222012221011111111111111110212001021022200121012112212110111111111111111011110101111
011011122122011012221212222111111111111a111101101011111121121102110220212120102111000111110101011111021220201122022201122021200222201111001111111011011110101111
111111001111111111011111111101011010111a111110011111111101101102211122112221220001211211111100111111102201221110011221112012211222111111111111111101111111110110
111101111101011111111111111111101110111a111111110100111111221110211111001212111012212201011110111110111111012110212012020212212211201111101111011001101111011110
110010111111111111111110110111111111111a110101111111111021220122010211112220221200212111111101111111112010202122112122101221212102211111111101111111101111111111
101111111011111111111111111111011111011a111111101111101111221010121111200201120220012011110110111111121020211111102002120122211011111111110111111011111011111111
111111111110111111111101011111111111011a111111011100111111022222100112121221021112211111110110111111021222022121111201011112201221210001110010100111111111111110
aaaaaaaaaaaaaaaaaaaaaaaaaaaaaaaaaaaaaaaa111101010111111120111012212112121200010012120111011111110011102211101222021112021212020122111111111111011111111101110101
1111111101111000100011011110101111100111111110101111110122111221012102110012222012212111011110111101011212112112112120221222001012111110111110110101011110111011
1111011111001101101100111011110110111110111111101101111101011011111111111111101111111010111001011101111221111111201211121222020101211101100011111110111011111111
0011010101222210020021022022111111111110001110111111111101010111110101111111111100011111110101010111022112010111110110012122101022111110111111011110011110111011
2201001010220000002201122210211110111111111111111110010111111111110111111110111110101111111111111110101222211211012002112112111222011101101111111110011111101111
1101221202201101221211211112110100011011010111000110111110011111000011101110111101101111011101111001102210121011210211211211222121211110111111101101111111111101
1112112212211210211021021102201110111111111111101101111011101101011111111111101100111011111111111111110011222122110122121120210211111111111001101101101101111111
2222012212102122211102121212211111111011111110011111111111101101111101111101111011110111111101011001110112102211121222111211010212111001111111111011011011111111
2112001001002212102220221121111111111101111111110101101110111100111111011111011111111111011111111111110101020220021221022220021222111111111111101011111100101111
1011112210112210221221211221011110101111111111110101011101110111111111111110111111110011111111011110111220022110101211022222121111111010110111111111110110111111
1002221222121001102110211012211001101111101101011111011111110011011111111110111011111110101100111100111121012212102210201111021111111111111111111111111011111011
2022011110121211020022102120211111110111101111101111100101111111111100111111111111111011111111011111011011101211112120222222222022201111001010011111011110111011
0122110001120222121221110111001111011111111101111111010111011011111101111111111111111111001111111111121121222200211010220212120210110111100011001110111110001111
2221011201012101022021121102011110111110110101111111000110111111111111111010111010111111101110001001110112112221222102112110220122211001111111110010111101111111
1211221222121211111122212200010010110111110111011011111111111111110000110111111111111111111011111101121202212200120112010212102221201101111111111011111111011111
0022012222121122111211112122211111110111111101001111110111111111011111110110110111111101111111111111110122010112121121222112202011011111101110111110111111111111
1012110112102211012211222102111111111101101001111111111111110111011111111011111101011011111110111111112222112101210120111112120112210101111011111111011111011111
1021021011011121012111112110210111011110111111011101111111001111110111011111111101111111111111011011112120112122002110201102121101211011111111111011111110111100
1211210112102111121110122121011111111101101111111111111101101110111101110111010110111111111111011011101111011101111011011111111010111011100111111111111111111111
2002202122220111212212212100211001011101101110100101111010011101111110110111111111110101010111111111110101111000101111111101101111111111101111101111111101111101
1122020221210222102202121012211101111111111111100011111010111100111111101111111011101111111111110100011110011101111111111111111111011111111011111111111111111111
1202101221022211102022111211210101111110011011111011111111111110110111111111111110111111111111100111101111111111010100011110111111111101101111011100111110111111
211221101101202222002121babaaaaaaaaaaaaaaaaaaaaaaaaaaaaaaaaaaaaaaaaaaaaaaaaaaaaaaaaaaaaaaaaaaaaaaaaaaaaaa1111111100111111111111111101101101111111111111111001110
102222010001122111122212b1210011111111011111111110111111001111111011110111111011101001111110101110111011a1001100111111101111111011011101111101111001111111111111
211110022012111021122220a2001111011110111011111111111111111111101101111101111111110111111111011101111011a0111111101110001110101010111110111111001111111111111111
211121122112221002100022b1222101111111111110101110111001111111011011111111111101101101111110111101111111a0111111111111111111011001111101110111111111010111001110
222102202222220222110112a1211111111111101111110111110011111111011011111111011101111010111111111111000111a0110111011011111110111111010011111111111111111001110011
102122221111112010001022a2222111001111011111101101101101110111111010111111111111111110111110111110111011a1011110111111111111100011110111101011111110011111111101
111221201222001122112221b1012111110101101011111010111010101101111111111111111111100110111100111111111011a1010100001111111111001101111111100110111010111111111011
010212222121212100211220a1210101111111111111111111111111011111101100111111111111111111101111100110110111a1111011111101011111011111110111110111110111011111010110
102222222101011110220212a1202111110111010111111110011101111111111011101110001111001101101111110111100111a1001111011011111111111111011111111111111111111111110111
211101112122021111011112b1021111011111111111101111111110111000111111111111111111111111110111111111111011a0111110101011111111111111110111110111111011011011111111
112111011211121122201111a2201011110011110011111111111010111111111111011111110111111110110010111111111101a1110111110111110111111111110011011111101111111111110111
111111011111110111110101a1111011111011001111110111111101111011011101111111101011111111111111111111101111a0001011010111111111111111111111111101110011111010110001
001111110111111110111111a1110101111010001111111110101100101011111011111111001111110111111101110101110101a0100011111001111101111101101111111011101001001111111111
111111111111111100111011a0111111111101101111011111101101111111111101101111010111111100011111011111110111a1101111011111111001001111101011111001111011111101011010
111110110111011111110001a0111101111011111110011111011010111010111111111111110010101101101111110111111111a1111111000010100000110111111111100111111101111011111001
111111010111111101111111a1111110111111111011110111111110111110111101011111111001011111111111011111011011a1111111111011101110101111111111001111101101111111111101
001111100111111010111001a1110011111101111111111110011011011101111110010011110111111111111111111111111111a1011111101110101101111111011011111111110101111111111111
110101101011111111111111a1111101011011111101111101001111110011011111111011111111111111111111101001111111a1011111111101111111011000011100010111101101111111111011
111011011110101101011111a1110111111111011110111111111101111111111111111010001101111111111111101111110100a1111110111110111110001110101111011011010110111111101111
011111001111111111110111a1111111111111101101111111101111111110111011010101111011111111111101011011110111a1101111110111111011111101111101111100011110111111100111
