(60,147)
(104,57)
(116,86)
(110,53)
(24,10)
(87,103)
(19,62)
(30,20)
(19,14)
(78,140)
111110111111111111110111111110111111111111111a11111101111101100110a110110101111110000111110111111011000110101111101010110101111101111101111101011111101111101111
111111010101111111111111101111111111111011100a11111101010010101110a111111000101101100110011111111101111110111011101011001011100111110111111011101111101100011011
011101101111111111011111111111111111100101110a11111011010111111110a110111111101111011111110111011111111111111011111100010111011011111111110111111111111101111111
111111111010111111010101111110011011111011001a11111111111111011111a111111011111111111111111111111111111110111100111111011111111110101111001111011011101111001111
122111200122211010121201111110111111101111101a11121021110120112112b221021122210111111011110111111100111111011111111111101011111111011011111111111111111111100111
212111121220221211120210122211111101110111111a12122212221122112212a212101210111111111110101111111111111110111111110011101111110111111111111111111011011100001111
122211220110011111111212200211111111111111110a10021222212111100120b210012222101110101011111111111111101111111111110111011111110011101111111111001110011101011111
101202201110021001111012202210111101111111111a00011121210112210201b202120011111111011011111111111101111011110001101010110110011111110111111111101111101111011111
221121221102222101112102021201011111111101101a10022011212212112102a201111210201111111111111101011011001110110111011011101101111011110101100111111001111010111111
200122122222212122211012012020101110101110011a12120221010210121022a120221222111111111111110111110111111111111111101011111010111111111111111011101101111111111101
221222121201000222202221222101001111011111111a11111022021212212020a211121022200111000111000111011011111111100111101110011111111011111110110111111111111111111111
202220102202220221222222211121010111101011111a10202220110220110222a201121111211111011110110010111111110111111111111111111111101111001110111001111110000101111111
101222220120022220022212210221111011111110100a12001221011121222110b021122111011111111111101011111010111101111001110111110111110111011111111011110011100111111011
221020212221222022222022120121110111111111111a02120212211221212010b202111021201111110111110111111111011111101101111111101111011111011110011111111111111101110101
222120112101211210222222011221111111111111110a12221122101111102120b102011020211101111001101110111110111111011111111111111111111001111110111011111111110111111111
210102202000222202222022221221002221111011101a10210020220110202000b102121211010111111011101111110111110010011101101101111111111111111110101100111111110011001111
221222220202222222222222220212010220110101111a11222012002120212222b022001212201011111111111101011111011111010101110111011110111111111111101011011111111111111011
211021222222222222220221202022022001011101111a12201212221210212020a012202202211111111111111101011111111110011011011111100111110010101111111111011111010101101011
221022022222222011222212222202200110011101101a10012012202102210211b112201121110011111011111101111111110111111110011110101110111111111111010011100111111110111111
222022120220220002222222102221111221100111011a02011111111021211112abaababaabaaaaaaaaaaaaaaaaaaaaaaaaaaaaaaa11110111111110111110101111111111101111101111011011111
bbbbbbbbbbbba02220002222222221110011110111101a010011211121102211122221211221211111111111111111101111111011a11011110101111111111111111110111111010111111101111111
222222222220b22220222222210201211021011011111a111211112201210022110221221011211110111111111111111111111111a11111111011011111111101110110111111111110111111011111
112022222222b02202122202000100012110111111111a121111121111220212212011121222111110111101111111101111111111a01100001111011101111110111111111111111011111010111111
022200202222b02022222222022010220100110111011a111210221210011012020222001021011111101011101111111111111111a11111111011111110101111111111111111111011111111111101
120212210022b22222122222002102211201001101100a021102212221220022211222221122211111101101111011101111011111a11111011001101110111110111111111011011110111110111011
212112222201b12212222222202202222021111110111a012120212011010011121112210212011111111101111110011011101110a11010011111110110110111111100111100111111110110111011
212222202220a12222220022200222100011111111111a121212221002122101122111011211101101111001111111111001111111a11111111111111101000000000010011110111110101000011101
222102222220b02102212222022002112201111111101a112212112022111211020212210121211111110111111111111110110111a11111101101111111111011101111011111110111010111111111
022120022220b22222022222211201212111011111101a022212122211101221011101112111201111111111101111111111111101a10011101011111101011111011011101101101001111101110101
202202221120b22110020220202021221210111011111a121112222102111012110111220122101111101111110111111001110111a01111011101111101011011101111111111010111111111101111
122222022222b22202222221222000222101111110111a122121220112222110101110001000011010101101111111111111111111a11011011110111111111101111111111110010011111111100111
122022022202a12222202222121202101010110111111a101201221110222012222222111221111101101111111111111111111111a11111111000011111001111011010111101011111101011100111
022022022002b02222222222021221101221111101111a121112201201120210211220211112111111111001111010011111100011a01100001011011111101111111101111111111001111111101111
222200222222a20202220200222210212011111111111a112200212221211002202221002101211111111011011111111111101111a11111111101101111111111111110101011110111111101101111
200002122022b20210120122012201222011111110111a111111101111111111101001111110101110111111111101011111111111a11110110111111000111111011111011011111110111111001101
111121212201b20222222102210102212221010011101a111111111111110101011111111111100111111110110111100010111101a10111111111101101111101111111110111111110010111010111
012222022200b22202221212211011121121111011111a011011111110110111111111111011111111010011111111101110101111a11110101111111111111101111101111101101111111111111111
121122022022a10201210220221122222221001110011a101111111111001111111101110111111111011101111111111101111111a01111111101101111110111111111111100111111111111111011
222112220221a12012121222002212200101111111111a111101111111111111111011111111111111011101111111111111111101a11111111111011111110011011110111111011110111111011111
111111211221b02121100022121101121201110101111a111111100011111111011101111011110111111111111101111111111111aaaaaaaaaaaaaaaaaaaaaaaaaaaaaaaaaaaaaaaaaaaaaaaaaaaaaa
111110212011b10211202212121111101021110111000a111110111111111011111011001111111111001110111111001111110111111111011100101111110101111110110001000110010011111111
011112212012b02122001101212120202121101111111a111111111011111111111111111101010111111110111011111101111111111110101111111111111111111001111011100111110111111110
111112020222b12121211012020110222121011101110a111101111111111111110111010000011111111111111011001100111111110110111111111111110111101111100111111111111100101101
111112122111a10222020222121212212221011111111a110100110101111111111111110011110101011111111010111011110111110011011100111110111101111011111101111111111101111100
111111121022b22021121022201211012121100111101a111011010111111111111101011011110111111111111101111110101011110111111111001111111011111101110111110011110110111111
111111111111a10111110010101111110101011111111a110111011110111111111101101101111111111111111111011101111111111111111111111111100111000111110111110111111111111111
111011111101a11110111001101111111101111111110a011011011111111010011111101111111011111111100111111111001111111111111111110101111011110101101111111011001110111101
110110101100a11111111111111111110111111111111a001111100111110010011111011100110111111110111111111101110111111010111111101110101111010110110111111111101010111011
111110111111a11111111110110110111111111111101a111111111111111111111111011110111111100010111111010111111011100110111001101111110111111111001101001011011111101111
111111111110a11111101111111011010111110010111a111100110111011010111111110111101110111111111110100111111111111111111101111111101110111111110011111011101111111010
111110111111a11111111111101110011110111111111a111111111011001111111101111111111111111111011111011110100111111111111111111111101111110101111111111101111111111111
011011110111a01111100111111101110010101101101a111110111111111111101111101101100111111111111111111111111001111111111001011110111111011011101110111101110111111110
011101011101a10011110101001111111111111101111a101111111111110111100110011011110011111101111010100001111111011101111101111110111111111111111111111111111111110101
111011011110a11011111101100100111011111111111a111011111111001110011011110111011101111111101011111100111111111100011111101101111111111111111011110101011111111111
011101111011a11111111001010111111011111111011a111101011111111100110110011111101101011110110111111111110110110111101111101111101101101111111111111110110011111111
111111111011a01111110110110010101011111101111a111111111111111011111101111111111111100011111011111011111111101101001111111101111101101111101111111111111111111111
111111111111a10100111101111111110111111110111a110111101111111011100110111101111111111001111111110101111111001111101110111110110111101101111101110111111111101111
111111111111a11110111111111001111110111111111a100011101111110111111111111111010111110011101111100111011111010111110111010011101101101101101111111010010111011111
111111011111a00011011011111000111100111111101a111110111111111100111111111110111111111010111111101110111001111111110111111110110011111111111111111110111111111111
111111111101a10101011110110111101011111111111aaaaaaaaaaaaaaaaaaaaaaaaaaaaaaaaaaaaaaaaaaaaaaaaaaaaaaaaaaaaaaaaaaaaaaaaaaaaaaaaaaaaaaaaaaaaaaaaaaaaaaaaaaaaaaaaaaa
111111111101a101100111011111110110111101111011011111011001100111111111111111111111101101111111111110111101111011111110111111111101011111110111111111011111111111
111111111011a101111111011101110010111001111110101000011111111111100111101111011111111101111111101111000111111111111111110101100001111100111111111111111111111110
111111111111a101101111101011111100101111111111111011110111111111101101111111110001101111111111010111111011111111011101111010100111110111011111111110011011101111
011101111111a111111100101111111010111111011111111111010111111111111101111111111111111111111101010011101011110111101011110101101001012111120101101110122020211111
111010100111a011111111111111011111111110111111111110010111111111101111111111111111111111111011110111111111111110100111111010111001021111221211121020102201211111
010111111101a110011110111010011010110001011011111001111111111110111110111011010111111111111111011011010011111111101101010111022002111011222211101120121101211111
101111111111a111101110011111111111111110110101110111011110011111111111111011101101111010111001111111111011111001101011111110110012120112212122002210122202211010
011111111111a111101101111000111011111111011011001111101110111111111110111101111010111011111111011111111111111011001111011111121221012021212021110220102111211111
111110011111a110101111110111110111011111001110111111011101011111111011111111111111111000111110111111110110111011101111101110011021110212120212221200102112111101
010111111111a111111111111101010111111111111111111100101111101111111111101111111111111111111111011011111111101111111111111100102220201121122211102202121012211111
111111101111a111111111101001111111101101111011111100111111110111110111110111101111110011111110111101111111111110111010111101022112111202012022222121121022111011
101110111111a101101101111111111101101101011111111111111100011110111001111110011111110111111111011110110111011011101110110111112122122202121211111112221211010111
111111011111a111111011111110111111111110111111111111111111111111111111101111110111101101201212121201021110102222221201111111111011012122112211111111221211111100
010110110011a011111111111111100111111011111001111111111111111111111111111111101111111111001120221010001211021021111122111011011221012111021101022210022121011011
111111011011a010111111111111111111111111110011100101110111111111111111111111111111111111021122122102220122011001212221111110012222211112201221121111122110011110
111100011110a111010100111111111111111111111010101111111001111111101101101111111111011111221210212110101211021012120200111110112210211212202222011112011110211011
011111011111a100101111011101111011001100101011111111110000011011110111111100110110111100201012221111111211221110201102111011112211121112001001112202212021001111
101101101101a111110111011011101101111111000010110111101110111011001111111111111111111111212112112120201110221021021211111101122102021101211111112222010220211110
001111110111a111111110111011011111111111111111101111011111111110111111111111111111001110210000121221011121122220101011111011101212201211020221212011121212201111
110110110111a110111111111101110101111011110101111101101111011111101111111000000110110111112022102111222101120200210111111111100211122221022100212212220011211101
111111111111a111110111111111011100111111101111110111111111111111111010111010111101111111011011112210111112211111121222111111120110112211212201220012221122111111
110111111101a110111101100101111111111101110111111011111111010011011111111111111111111110211222011210002022221020101221111101112102220120121111121201222220111110
101010111111a101011111111111111111101111111111111111111010101110111111011111111111101110202210111200010211122122121012101111110211210222110220221121012112211101
010100101111a111111111111111011111000101110110111101011101111111111111000111111111101111020112202121220211111111012212011111121211212012022111210210211222111111
111111011111a100111111111111111011111011101111111101111011111111111011110111111110111111212102222201021211011122022200101111122201211011011222112212021121011111
001111111111a111101011101001111011111111111111111111111100111110111111101111111110110111022221021200112201021220211212101010122010012012222122002212112111210111
111100101111a110111010111111111111111111111111010111111111111011011100111010100001110111200202212211111110202111121211111101120112220020022100212201212121210111
110111111111a110111010010101111111111101111111111111111111111111111111111111101111101001112010122101112101112202220122111011112112112102121101122221102212111011
011110101111a111011111110110111101111111111111011000111110110111111111110011011111111111121221211111022122120122201221110011121201212101012220121211012222111111
010111111001a111111100111111111011111111111110010011101110110010101110111111111011111101121121121200122111212110110122010100122210110221012221210121101012011111
011111101011a111111111111010111111111001aaaaaaaaaaaaaaaaaaaaaaaaaaaaaaaaaaaaaaaaaaaaaaaabaababbaabaaababbaabbbbaababbaaaaaaaabbbbaabbbaabbabbaabbbbbaaabbabaaaaa
011101111101a001111111111111101010110110a10011111110101111111101111111111111111110111001012010222220111110111021011102100111022111222221211221202112211122111011
101101111111a111111101111011110111111111a11111111111110111010011011001111111101111111100122222201021121111200210112221101111122110121121212101102122122122011011
100111111011a010111111111011011101110011a11011111001111101101011111011111111001111111111202212121212221120001002220222111111011111111110111111110100101111111111
111111111110a110111111101101101001111111a01111011111110111001111011101111101011110111111022111222100211012100220111201101110111111111111111100111111111101010111
111111110101a011111111111111011111001111a11222120222122010222021021111111110110101111111221102222111222100122112122221110111111111111111111111101111101110011111
111111010111a111111111111110111111111122a12022212121000022211011211111111101111111111101222220220021002202112121201011111011111111111111111011111110110111111111
111111011110a111101111111101111011100002b11100012221222000211211111101111100111111111111120110222221212222211112111221110111111110111011110111111111101111110101
011101111111a001110111111101111111111122a01212200211121202221001122211111110111111101101121221121110011102102222211020111100111111110111111111100111011110101111
110100111111a011111111111101111011111021a21211111002221202111020210100101111111101011111222100100122212222112210122210111011111101011111101111011111100111101011
010111110111a111111110111111100111111012b12111121212222012212111212111101111111010111110220120221121100201112200122211011111111111111100111111111011110110110110
011110101111a011101111101111111111111111a22101120200021122022201122010001122202221102122222221022222222212222212211112011111101111111011111111110111111110011001
011110111101a011111111101111111111110121b20011221111221211121102012111112122210120120201211222121012010000111101100011111101101101011111110111111101101001110110
110111111111a110101111001111101111111021b20222222220010121222212012110020110022220001122022111221121101101101111001111111111011111111111011101111011111000101101
011111111111a011011110101101111101111102a21012201012212221200221112211100212102101101221222011001122211111111110111001101011001111111011110100111111110101111111
110111111111a111111111111111110111111110b21111112020111021101221111111112211212211211122221000112012211110011111111101111111111111111110111111111010111111111111
110111111111a011110111101110111111110121a22101012222221012200122111111112021112222220022210222101202211111101111101101101111111101111111111111111111110111011111
100111011110a110010110001101011101100121a12021021112200222010200201210012011111120111210121222122022011111111111111111111011110011001110111101111111101101111110
011111110001a111111111110010110110110111a11121020222121201011122021110102120111212022022212010021210211111011001110111110110101111111111111111011111111101111111
111111111111a110101111101111110001111120a21002222112001111121101121210110001101222102121120220212202111100111011111111111111010110111011111111110111110101111111
111111111011a111111111011110111110101111a11222201220121211111211202211011022021102212221222112220202211111110111100011111110011001011111110100110101101101011101
111111011101a111111100111111111001110122b22112212202102212211011101211011211222102020211020112111121210010111111110111111111111011111111111111111011111111111111
110111100111a110100111110101111110110112a12022111212212212222122221110122121001102222121211200212122201011101111111110111101011111110111001111111010110011111111
011001111111a011111111011110101111011121b12211211222200201222000112111121201012221220220212111022220211111111111011111111101111111111011111110111111111111110011
101111111110a111111111111101101101111111a12202221021110211221200002201022200122222121122211010121021110110111111111111011111110111111111111101111110111101101111
111100111111a111101111111111111111111001a10112012210202001211022212110122121120110122211111102221122211111111111010111110111111100111110111111110011110110111101
111111111011a111111111111111110111111121b11210121102210111111120010111112212012220202210100102122221211111111110110101111110111111110111111101111101001110011101
111111101011a100111111111110111111111101b22000112212121020111012211101112111222121211111000101021200101001111110101111111111110110111111101011101111111110011101
110111111101a111111110111111101111111022a10022011211021111202221110101120011102202112112120120120122211010011111011111101111011011101111110010101110111101111101
110011011101a010110011111111111111110120a11122022112122202121222221110011010221121020201122201120121111111111110110110111111111101111100101011111101111101111111
