(3,76)(108,153)(103,89)(118,131)(1,101)(117,20)(62,145)(116,124)(13,30)(5,43)
(119,8)(68,10)(2,115)(100,16)(100,129)(36,140)(32,12)(6,6)(68,140)(99,87)
(12,6)
(89,30)
(104,116)
(50,50)
(74,43)
(86,93)
(53,31)
(110,130)
1211112222212112101121111111111111111111100111111111111101001101111110101111101111111111111111010110111a11110111111101111110011111110111111111111110011111111aa1
1211022202100222022201111111111111111011111111111111110111111111110111101010111111110110101111111111111a11111100101111111111111110111111110111111111111111111a10
abbbbbbaaabbbabaaababaaaaaaaaaaaaaaaaaaaaaaaaaaaaaaaaaaaaaaaaaaaaaaaaaaaaaaaaaaaaaaaaaaaaaaaaaaaaaaa101a11011101101111011011101111101110101011111111110101111a11
121021002120211112102111111111111101111101111111111111111101101111111111111111101111111110011111110a111a11111111111111100111101101100101111101111101111111011a10
001201010202211110010011111011111001110111111010011011111110100111111111111111111101101111111101111a111a11110110111111111111111011111111110111100111111111111a00
111122202222100122211011101111111111011111111111110111111110111111111011111111010111011111010111010a111a01110101010010111011110111101111110111111110111001011a11
210212111011021212111111101111111010111110111110011010111111111011110101111111110111101011111011011a111a11010111011110110111101101111101010110011001111101110a11
102010201212212211121101011111111011111001111110111111111010111111111111111101111110011110111110111a111a11101101011111111111100011110111111011111110111111111a11
112011022210012020011101111111011111001100111110111111111111111111011011111011111110101011111101000a110a01111111110111111101010101111110000111111111111101111a11
212110112121122022101111101011111011001111111101111111111001011111111111110111111101011111111110111a111a11111110111111111011111111100111011111111110111111111a10
102202120102121221122101111011111111101111101101100011111111011111101111100111111111110111111111111a111a10010111111111100011111111001111110011111101111111111a11
111112120212121002021111111111000001111010111111111111111111001101101111001111101111111111111101111a111a11111111101010111111110110111111101011111011111111011a11
220120201212122210201111111111100111110011101111011111111111011110111111111101111111110111101111110a101a01111011110011111001110111011111111111111111111001111a11
110211122211112111101111111011111111101111011111011101111111011111111111101111111111011111101110010a111a11111111001101101111111011111111110111111011111111111a01
020122012020021011121110001111110101111111111111111111111111101111011010010111011110011111101111110a111a10111111111111101110110111011111111111110011111111111a11
121200211111100110011111110111101111011011110111111111101100111110111111111011111111101001111101111a111a11111110111111111111111101010111111111111000111111111a11
222121202122200222110111111111111111111111111011111111111111111001111011111000110111111111111101111a110a11101111111001111111010111111111111101110101111101001a11
122112022221211212020011111111101101101111111110111100111111111101101111110111110111110111111111111a111a11111111111110111011111101111011111011111111101110111a10
111022012111111112001101111001111001111011010111110111001110111110111011010011011111111111111111110a111a11111111011111101111110111011101111111111111111111111a11
220102122201111210222111111101100011010101011110011111011111101111101111110101011110011110011100110a011a11111010001101111111100111111111111101111110011110101a11
212222101012221001220111111111011111110111111111110111111111111111011111110101100111111111100011111a101a10001010100101111101110101111111001101110011110011111a00
210212122221021122011011111111000101111001101111101110011111011011111111100110111101101111111111111a111a11111110001111110111111111111011101111111111111110101a11
abbabbaabbbbabbbaaaaaaaaaaaaaaaaaaaaaaaaaaaaaaaaaaaaaaaaaaaaaaaaaaaaaaaaaaaaaaaaaaaaaaaaaaaaaaaaaaaa101a11101010111111011001111111011111111110111111111011011a11
2011220222201122102101111101111111111011111111101110111111101111111111111111111101011011011011111101101a10101111111110101111111011111111111101110111111010011a11
1121112102021220011221011101111111110111000111111111111011011111111111111110111111111110101111111101110a11111001111111111111100110111111110011101111011011111a11
2112111011221212201011111110111111110111101111111100011110010111111111111110011110111100111111111101111a10110111011101111011101111111110111011110111011101111a11
2210211212222121110201101011111111111101111111111111111110111110111110110111111111111101001110011100101a11111111111110011011010111111111010000110111011001011a11
1011111111111111111111111111111101010111111111110111111111111111110111111100110010111011110111101111111a11011111111111111111110111111010110111111011010111111a10
1111110111101111111000111111101011111110100111010111101101001111111011100101011111010111111110111111111a00111111111111101110111011101111111010111111111101111a11
1111111111110111011010111011111111101101111111101111101100110111100111111111111011111011111011111111001a11111111111111101101111111101111101111101110111111110a11
0111110101111111111010111111110101111101111111111110111101111110111100111111111001110110110011101101111a01101101110111111111111111111101011111111011011111111a11
1101011110010111111110111111111111011111101111111110111111110101111111111111111111111101011011111111101a11100110101001110111011111111101110101111111111111101a01
1111101110111101111011111110111110111001011101110111011111101111111111111111111111000010100011010111000a11001010111010111111111111111110111110100111110110111a11
0110110110010101111011111011011001101111111111111111111110111111111111111111111111010110101111111011111a01111111111101110111111101111011111111110101111111111a10
1000111111110011100011011010111011011011110111100011000111111111101111011111011111111110111111111111010a01011110111111111110011111111011101111111111111111101a11
1110110111111111111111011111111011112211122211222022221222012102211110011000111111111011101110111111111a11100111101101011111111111111000011011111111111110011a01
1101101011101101111111011101101111120021102220221201021211021012111110111101111111011111011101111001111a01110111011101111111111101111011111111111111111110011a11
1110110111111111110111111001111011122021221001001011112111222121210111110011111111111111011111111111111a11011111110111110111110110111111111111111011011111111a10
1100111101111101202102112102211202122202222202021001120101211212210101110101110011111011101010110011101a10111111110110111110111011111111111100111110111101101a11
1111111110111110102211112202200010212220122212120112111110111102211110111110001111011101001101111101010aaaaaaaaaaaaaaaaaaaaaaaaaaaaaaaaaaaaaaaaa1111111111111a11
11110010111111101122022021111121021200110222221122120201122112001111011111111111010111111110111111100111010111011101111111111111100111111111101a1100111111101a10
10111111010111110112122202121111021102222222021212022010021102102011111011111101110111111100010011111110111101011111011111111011110111010111011a1111110111011a10
01111101110111110112211221101210001221220222202202020122201121211101011111011110111111111111111111110101101111111111110010111101101111110111011a1111100110011a10
11110111110011100211111211220110220220022122200202111012010112101111111100111111001011111110101111010111011111110111111110111111110011111111001a1011110110011a11
11111110011111112121222012222222022012102220022122111102011120221111111111110011110111111011111011101111111011111110110111111111101111110101111a1101111111101a10
01111110111111111211102101212221100202221222221201122011211222112111111101111111111111001011110111001110011101011100111111011111111111111101101a1101101111111a01
11111111110011111200111111120220211201212101220122122202222202121011111010111101111111111110111111111001101010111111111011011111111111111111101a1101001111111a01
01011101100110112101121010210122112212022002222221222101222121121111000111111111111111111010011111111111111110111001111111110111111111011111111a1111101101001a11
10110111111011011120212110111202111202212022011122122011020210110110011011111011001110011111111001110110111111101011111111101101101111111111111a1011111011101a10
01111111111111012122112021221222111220122222200122202222200012102111101111001111100110011101101011111110111111011110111111111011111110111111011a1011111111110a11
01011011011111102221211110022000101112122201222212101112111200111111111111001110011111111111101111011110111111111111001011111111101111110011111a1110111110110a01
11111101110111012221221101012221120221222122222112111112112200011101111101111011110110111110011111011011110111111111011101101101111111011111111a0111111111010a11
10011101011111112101222111020012211221222121011111121112110102211100111011011011011101110111001101011000111111111100111111111001101011101101111a1111110011111a11
10011111111011112212222011021111121222222222221022121122112211220111111011010101111001111110101101011110110111111111111111111111111011011000111a1111111111110a11
01111101111111011212211212212112122222121122200212211212010112011101111010111111011111001111011111110111110111100110100111111110111111101101010a1111011111001a11
10111110011011112122110021020200210002022102122122222021121212101111111111111110110111111111111111111100111100110011110011110011110110100111001a0101011111100a11
01111110101111112112212122211122120222220222222202012222022001012110110110101110111111111001111011111011110111111110111101111111111011101111111a0111010010111a11
11110111001101112120011022221122211220222121222210112110111012200111101111111111011001111111001111011011111101111101110011111110111001001111111a1111111111111a11
11011111111101011221122112111021102120220210121121122001212020222011110111111011111011111111111111011010111100111111111011111111111011101100011a1011111101111a11
11110111001111111111220220102202222222220122120202001022121012220111001111101011011111111101101101011111011111111111111111110111101111100111111a1111111100111a11
11101101111101110122211222202021220012222022212122002222102222211010111110111111111110111111111111111111110011101110111110111111110000101111111a1111011111100a11
10111111011111112220012222212222221220022221220112022112211000022111011111111111011111111111111110011011111000110111110110110111110111111111101a0111111001111a11
11111110010101112120101211101201202222020220222211200210202112122111011111111111111111011000111111111111001111111111111111111010111111111111000a1101111111111a10
11111111111111111222202121222100222202022222022210212122102000212111111011111111011111111011111111101111111111111101111011011111110111111111110a1111111111011a11
00111111111110111110222212220222211022022221221220120000221201210111011101101111111111111111111111101111111011111111101110011110111111101101011a1111110011011a01
11001011010100112201022012210020222201120122221212121202211111101101111111001101111111011110010111111101011111111111010111010101111111111110111a1111111011101a10
10111100111111112211222011010011210202022202122201100121110110101111001111111101111111111011101110101101111110110111100111111010111110111111111a1111111111111a11
01111111111111011202222211221022122222011121201210121101111111111110111111111101111011111111111011111110110110111111111110101111110011011011111a1111101011111a11
11111111111111111111110101112221122220101011212212200102011111111100011111101111110111110011111111011011110111101101010011111111111111111110111a0111111100011a10
11111111111010011111111111110210102212211122122222221011211101011111111100101111111111111110101111011001011001111111011011111111101111111111111a1111011111011a01
11111111110110101111001110111022011120211121122222002122211111111011111111100011011100111001010011011110111111110111111111111111111111111001111a1111111110110a11
01111101111101110110111111111222212010100111122212212111021110111100111101111121021202202111220122101112121111101100010111011111110111010110111a1101111110110a11
01101011111011101111111111110011112221221022112221212112111011101110000101011102202010111122222102112121220210111100110111111111111110111001011a1110111100111a11
10111111101101100111111111110012011222222020101211122202110111111110001111111121102111022212102122122211102111111111110011111010111101111110011a1111111110111a11
01110110111101111222111221210012202012112121201211112212221111111011011100011112202112221122211201121021021210100111111011111011111111111111011a1111001111101a11
11111111110111102220011202102120021200222122022111112212100101111101011111010101121112222202022122200022121211101011111011111111110111111111011a1110101110111a10
11111011111111122111120011002220221222222222021200202220011010110011011011111122122210122120220101101220212111011110011001111111111001111101111a1111111010111a11
11111110111111012100110022222122202202112222120222220211220111110011111011110111111112012121212101202221020211111111110111111110111001111011111a0110101111111a11
10110101111111121101121012022222122022122220111120122221201110111101111111111102112012201011201121222221111111111101011101101111110011011011111a1111001110111a11
aaaaaaaaaaaaaaabbabbaabbabbabbbbbbbbbbaababbbaababbbbbbbbbaaaaaaaaaaaaaaaaaaaababbaaaabaaababbaaabbabbaabaabaaaaaaaaaaaaaaaaaaaaaaaaaaaaaaaaaaaa1111111011111a11
aaaaaaaaaaaaaaaaaababaaabbbabbabbbbbbabbabbbabab1201200212111011011110101011011202211100121111220022212100221000010101111111101101111111011111110111111111111a11
11101011111111102212012201122122021222222211112b0122221011101111111111111111102012020202111221012101120112011011111111110111110011111011101111111101101111110a11
10010110101111121121221121012220211220222221200b1112022122110111111101011111112120222111122221020122221121220111110101101100111110110111110011101111011110111a11
11101101111111022211212120110022201120221122220a0211011212111111111111011001110111202202212212202210112211221111011111110011111001111111100011111110101101111a11
11101110111111122201111010222212202201222211020b1012221111110001111111111111110212221012220111222211201220101111110101111110101011111111100111111000011100110a11
11111110110111122012212221212222222022222112012a2121211221111111101111111101101220111222102200210200211100201110111111011001111110111111111111101111110110111a11
11111111011111121121021002111200112022000210221a2120012220111111111101110111112210201212222102021111011112221011111101111011111101001111111101101111011111100a11
11111011101101102021102101212120100221211022202a2002122212011001111101011010110110210101121221202221100112121110101111111101110011111111111111001001110011111a11
01101111010011102221220020222111122220011222022a2221222121100111111111111110112221012122111212111021112222101101111110111010111111101111111111111011111111111a11
11111111111110122220002122111222122110121212111a1111110111011111010111011101112111221212212111200211022022212121001121012010122101211111111111110011111111110a11
00111111111111012212112010122000112210021122001a1111101111110111111111111110112122012112212112120121122222101222022121001221200222011111011111100111011101010a11
11101111111111112022002121112101201112112020111a1111111010111111111111111010112212211121121100222102220222222110110212210210221111111111111110100011111111011a01
11011111111101121211121122012002022122012022111a1111111101111011011101110110111122200111112112202101011222222021122012211202122222110111110101111110111111011a11
10111111011101110022122122121212222102202021101a1011111010111111111111111101011112221212212221222110102202222022210121210122122112011000111010011101111111111a11
11101111111111111022222111121110200200212112211a0101111101111111001111111111111222122220221112101111010220220111101212221120221110111111010100110111011011011a11
11011011111101111112011211012221000220112222111a0111111111111111111111110111112011011211021122020120012021211021222212222222210122021222122210211111111011111a00
11111111111110110120022022020122210122010222210a1110011111101111111111111111112222202121211222101110222022122222202220202021222220110221222022221110111110110a11
11101011111001100121012222221012221120212201201a1110111110001111101111111111112210022102100221221121120121012121011122220222122202100110222012212110110011001a11
11011111110011101111120111220222121222112221211a1111110111111110111110011111110011222001122211010211020222112211112122212222222222222100102202112111111111010a01
11111110111111110102212121021202121202121122111a0101101101101011111001011011111122220111212010221200221220101122101000102222002220111212220012201110110111101a11
11111100101011121222202102021211111222222201211aaaaaaaaaaaaaaaaaaaaaaaaaaaaaaaabaaaaaaba111211101011122222212122122022200222222222220221102202201111011111101a11
111111111111111221212120211112122022111210121011101111111111110110111011111101111111011a111111101111120021011002212222222222122022121222211122200111110111111a01
111111111111111102111010111222110101212012210011011011111101011111111111011111111110100a110110111111102212101201102222022220012222112121112122222110101011111a01
111101111011110022102122221212101000120012101011111111000011110101011111111111111010101a111111111111110022122022112100212220222021112111110201111111110111110a11
111000101111101011011011111111111100101011111110111111101110111111110111111101111111111a111111111001112212221101111222121222202222211020210022121110111111111a11
111111111110111101111101011111111111111111101111111001001101101110011011101111110111111a100100101101110222110221222201022201022222212210212222001111110011011a01
101111111011111111111111111111111111111111111111101111111111111111111111111110011111011a111111111011111020102112222022122020210222220112121201011111111111011a11
111111110011101110111101100010111011110101111111110111111101101100111011111110111101111a111111111101012222010002111222222120011221121002111221200111101111001a11
110101111010111011111111110011011011111101111011111111111111111111111101101011111111111a110110110100121101110121021202221120222212220200100122111111110011100a01
111100111111010111111111111111110100111100111110111110110011101111111111101011111111101a011111101010002211222200002102002202221122202112212122212011011101111a00
111111101111111010111111011100111111111111110111111111111001011111111100011011101111111a111111110110120111122212201220022020221102110211000210022111111111101a11
110110111010100110110001011111111111111111111111111100011111111011110111110111111101011a111111111111112110221222202202002212202022222121212222122110011011111a11
110111111110110111111111111011101011011111111111011010111111111111111111011100001111100a111110011111121021201110012220122212222220122221122011200011111011111a10
111111010010110111111111111001101011111111011111111111011111110110111111111110110011110a011101111101122020011011221201102221022012210021121121221111101110101a10
111111111110111111111110111101111010010110110010111111100111001111011111111101111111101a111110111111122112212222100222220222222122211012210121211110111111010a11
111111101111101111010111111111110111111110111111111111111111111101111111111010011111111a111111111101101221010221101222122222202222122121101010120111011110111a00
111111010101011111100111101111111110111001011101101111101111111101011011010111111110101a111111111111110211222220011122012012221222001101110112110111111011111a11
011111111111111111101001011110110111111111111011100111111111001101111011111110111111111a111111111111012212101121122212220222021122200221200200102111111011111a11
111111111111111111111111111111111111110111110111111011111001111101111111111111110100111a111011111111110210101021110222221012122022122211210002212111111111111a00
110111111111001111111101111111001110110111100110111111111011111111101110111111111111110a111111111111111100011111100021101121221122211120211222202011101111111a01
