(108,96)
(9,62)
(92,90)
(98,36)
(9,58)
(24,83)
(29,33)
(74,98)
(109,43)
(54,107)
0101111a11110111111011111111011111111111101212112122021110122221010a1222201111111111101011111100111010001111111010111111111a10101111110001101111111111011a111111
0111111a11100111111111011111011110110111110110110201102221112012002a2112211111110101001111111110101111111111111111011110010a11111011111111111111001111011a111111
1011011a11011111001101111101110011011111001122202102222210212212011b1222111011101011111111111111101110011111111101111111111a11011110010101111011111111111a000111
1001111a11111111101110101111111111011101111021111102101122100110221b2122211110101111110111110101101111111101111011111010111a01111101011101011111111001111a111011
1111111a11111011111011101111101001111111101221221210202112201122020b1211011111011111101110011111111101111111111011111101111a11111111111111111111111110110a111111
1111111a11111101011111111111111011101101111200212121012211112220222b2210111111111111101011101111111110111111110011001110111a11111101111111011101111111001a011011
0011101a11011011011101111111111111011101111221220120222112222211111b2221211101101011110010100011110011011111111011001111101a01111101011111001111111111011a111111
0111111a11111101011011101111111111111111111022201222102221010211121b1220111111111101110111111111101111110001111111101101111a01110111011011111111111110101a110100
1010101a01111111111111111001111010011111111112221222022202122202202a1200111101111110110111111011101011011111111111111111111a11101111111111111101111111001a111011
1101111a11110101001111111010101011111111111021102220101121020112021b2222000022002222112010111212211110111110111100101111111a11101001101011111011111011111a111111
1101111a11111111011111100111110111110011111102120111021212112101112b2210211202100110111221110111121011111011010111001111101a11111100101111111111111010111a011011
1011110a11001101111111110111111111111111100121222102210201012202122b2221120221121112222101221101021111011110011111111111111a10111111101111110110111111111a101011
1101111a11111111110111011111111011110111111012100212220112011021121a0012211111012110120122110022111111100111111011111110111a11110111111011110110101111111a010110
0111001a11111111111111011111111011101110110220012021222121221001122a1200211022021220211211121122111111001111111011111111011a11011111111011101111111001111a101111
1111111a10111111112102112001112102012121221222221001212112210212221a1212220121122112202111211211221111010011111110111011111a10011111111110011111101111111a111011
1111001a10111101111102210022110122221211101222001110221211212011020a0112001121120222222212201200121111011111111110101101111a11111100111111111111111001111a111111
1111111a11111111111211120212211122212211112220111111221212211111112b1121002122221022222122210111221111110111110111111110111a11111111111111111111111001111a111111
1011111a11111111110102220102202212121111110222221102220120112122202b0202020022210122201110222211210001111111110111100111111a11011111111110111111110111111a111000
1110110a11011110112012211220120111110221222222211211122121122110211a0221011100021022211111211101110111111111101011111111111a11110101111111111111001010110a111111
1110011a11101111111212121211221221112202211022222212211121212201200b1222002011110200011111121110011011111110101111110110101a01110111111011011110111111111a111101
1111111a11001011102001212212012221122221201220220221102222212121212a1212201122002212011111212210211111101011111111101111110a01111111110101111001011110101a111111
1111101a11111111110012121020212120121110000221222002221122222122110a2121220022220221012012110220221111110111110111111101110a11110110101111111111111111111a111111
1111110a11101010112111222211122212110212222222020122122011121121121a0121022222210101101202221022211111011111110110011111111a11011111111111101111001101101a101111
1110101a10111111111221220101201122120120020020122212211101100210220b0222212102210200212002010111121011111001111000111110010a11011111011011101001110111111a111011
1111101a10111111111112202122210121122101221100201011111110111110111a2120102122022110222202221212221111111111111011110100110a10110011111111111111110111111a101110
1100100a11111111112222222011020212011222222220001101111111011101111a0122211221221121110012011012111111010111111111110111111a01111010111111111100111111111a110111
1111111a10111111011111200212021102201112212221111011011111011011110a2202220001021111102122100120221111111101101011011101111a11111001101111101101111111111a111111
1101100a11100111111111222011011120101120110222201010111101101111110a2220112200120120102112122212101111111011101110110001011a11111110110101111111111111011a111111
1111010a11111111112112212211111120220222012021110011110111011000011a1211210111112000221221021120211111000011011111101111111a11011111101111111111111111111a011110
0111111a00101111111221121111012222210021021122221100111101101110101a2112122201211220001120020201021111101111011111111111111a11111101100111111111011011111a111111
0111011a11111101110202121121220211102112122220211110111011111111101a0101221110011211111220222112221111111100111111101111010a10111110010011101111110101111a111001
1101110a01111101112101201121221000122222111122121111101111101111111a2012022021122002111121112211011011111111110011111111111a11111111111111111111010111111a111111
1111101a01110111011100110212022110111112022200111111111101101100101a0121222121222122002112211122111101011110101111111111111a01111110111111010111011111101a101111
1111111a11110101112112111122122020022222111121010111111110111011010a0221211221120211212001212021221101011110111010110111111a01101111111111111101111111101a111111
1111111a11111110110221022212201102122212010222221111100011111111111a1102101121102102210010212121221110111101111110111011111a11110111011111110011111101111a111110
1111110a01101011012022011122001120022121112222121111101010011111101a2210110022102212002201210221021110111111101110111011100a10111110111100100111111101111a111111
1101011a11011111110221010022112212121002121110111111111111101110001a1221022212120221212222222222221011111111010011111011111a11111001111111101111101111011a111101
1101110a11111111110022221200211211121122102102121010111101111111000a2111222112212121112221112111120110111111011111111011101a11111111111111011111111101111a001011
1101001a01101110110101102221211220121212012212211010111111111101111a1222222101112111221120202112120111111111111111111111111a10110101110110111110101111111a011110
1111111aaaaaaaaaaababbbabbbbbbaaaabbbaababaaaaabaaaaaaaaaaaaaaaaaaaa1111101111110111111111112222112200102020112111122222121a11110100011111111111101110111a111010
011111111011110110111221111100101221110122012111101001111111110101101111111111111111101110012222202122222002221202011202211a11111110010011010111111111001a101101
111111011111111111211101202202220121022200111210101111111111111111101111111111110001111110012110112201211111111221011122221a11111111010111101010110001111a111111
111111110111110111211122120022112221221212212012111011101011111110111111110111111100111011112112222222100221021220102111221a01111111110111101011001101011a010011
111101101010010011121221111212011211212220022010101111111011111001111101111111111111110011112222201012020222102122102022121a01011011111111111111110110111a111111
110111101101101011101111011111111111011000110111111111111111101111111111101111111100111101111212021000011111222111221021211a01001111111101111101111100111a111111
011011111001100111111111111101101100111111111011111110011101011111111111111111111110111011112211220211221102201021222120211a11110111111111111110011111111a111111
111111111101111111111011111101111011111101110011101001111111111111111011111111111011101011102202002222001120222120102102101a11111111111100111101101111111a111111
101011101011001111101111111111110010101111111110110111111111111111111111111111111100010101111012211100121112000222211222121a11110011101111111101111110111a011011
110101111111111110111111011011101101101101111111101111111110110110000111001101111111111011011101222221101120212021102112201a11101111111111111111011100111a110111
111111111100010101111100111111111001101111111111111110111010111111111111011111111111011111112121111111021211221101221211121a01110111111100111111110101111a111111
011011111111101110111011111111011100111011111001111011110111111110111011111001111111101111110001100221221202022121211121220a11111011111011110110111111001a110111
111101010111101101110011011110111111111111111011110100111111110011111111100011110111101101101220021212201121121121121020220a11011111110011011011110111011a111111
000101111110111101110011101111111110111111111111110110110111111111101111111111111111111111111002101022010222122202122112121a01111111111111001111111101111a111101
111111111011111101001111101111101010111111111111101001111111111111011111101111111011111111111210122211201211012121111211111a10111101111110111111100111111a111111
110001011111111111011100101101111111111111111111111111111111110011111101111101110010011101111020221112000221222112112102211a11011100110011101110111111110a011101
aaaaaaaaaaaaaaaaaaaaaaaaaaaaaaaaaaaaaaaa10110101111111110110111110111111111011111111110101110211202212012110102211022122021a00111111111111110111110101111a111001
111001101111111110101111111110111101101a11101010110111111111111011111111011111101111100111111102012021122220202210210012121a11111101111111110111010111010a001011
011011110011111110010111111011001111010a11100111001110111111110111111011110111110110111111112122010220112222221222221222121a11111110010111101011010111100a010111
110100001111011111111111101001010110110a11111011111111111101110111111101111111011111111101111112112101111110111011211112221a01111110011011111101111101101a111111
111111111110111111111011011110111111110a11111111001101101111111111111011111110101011022212102021212200001220222121122111011a11111110111011111111111111111a111110
111111101111101101011111010111110111111a11001100111011111101101111111110111111111111111221101202120210221122121011212220011a11111111111111111111111111111a100111
111110111011111111100111101101011110111a10111110011111110111111110011110011111111110120210211121222222222222221221022020210a11111001110111101111100101110a111111
111111101001011011111111111111111101111a10011111111111101110111101011010111011101112011102212022212102220122112221122111201a00111111111111111111111011101a111111
110010111111111111111111111111011111001a00111111111111111101111101111111101111111111110122222202122222122122202201011122101a11111111011011110111010111111a111111
101111101111011101111101110100101011011a11111011111110101101111111111111111111111112122200112220212221112222212212210111211a11111111111110111101010111111a111111
111111111111110111101010011111111111111a11111111011111110011011111100111110110111112002112222020021222220222020221202211110a11111110111111101111111111111a110111
110110101111111111101101011111100111110a11111110010111101111110110111101111111110111212221221221022111112201222221112100111a00111111101101111111111101100a101110
111110111101010111111111101111011110101a11011111111111110111111101111111110111001000122122202120212122112210210212002122211a11101111111001101110001110111a111111
111111110111111111100111011111110111110a11101111101111011111011011111111011111111111110112212020010012202220112211212222221a10011111101101110111111111111a011111
000111111001111111111110111111100101111a11111010010111100011111111001111111111101111222112212112102112112221010200111111111a11111101100010101111110111111a111111
110001111111111101111011101101111011111a11111111111011011011101111111111110110011111220211120122212002112011210211110111111a11110101011011101110111111111a111111
111101110101011011111100111111111111111a11111111111011111111100111111111111101111112212220120112202112112112012120111100110a01101011111100101110101111011a101011
111011011110111111111101111111011111111a11110111111010000110100110111111111111001110101212220212112021111222110021111111111a10110011111111101110011101111a111111
111110101111100111010110101111101111100a11111111101011110011000111111110111100111112222122121220022222122212121210101111111a11011110001111011111110111010a110111
111111111111111111110111111111111101011a01111111111011111101011111111100111111111110122221222122111211000212222211111110101a11110011111011111100111011111a110110
111001011110110011111111110110111111111aaaaaaaaaaaaaaaaaaaaaaaaaaaaaaaaaaaaaaaaaaaabbbaaababaaaabaabaabbbabbbaabaaaaaaaa110a11111111110111111111110101111a010011
01111101111111000111011111011111111111111111111111110111111100010101101011110011111222022120120222220102221211202110111a111a01011111111111101111011111111a110111
11101101111101111011101111110111111101111111011011010111011011111110110111121222111212212121222222201222212221201111110a111a11110110111111111111111111011a111011
11010111000011111101111010011111011101110111111101111101110110011011111111112112121201202212110222220222101222001111111a101a11101010110111111111111111101a011111
11101111011111111101111111111111001110111110111110111101110110100111111111101012001221222202022000202222212102120010111a001aaaaaaaaaaaaaaaaaaaaa111110111a011111
11111111110111011110010111111111101111110011001011100101111100110111111111121011121020202212221021200222200022120101111a01010011111011101101111a111111111a101110
01110101111111111111111111011111001101101111111111111111110101011100111011122211112222222022222222220002100211211111101a11111111111011111110111a011011111a101111
11011111110101111011101111111011001101100111111111101111101111011111111111111221122212222222222212222020211222010101111a11111110101111011100111a011111010a011111
11110011111101101111101212112001122212212221210001201001111110111111110111121122101200121221112222222200121111202101000a11110111111111111011010a011100101a111111
11001100111111011111121210221211210121211011211222211111011111011111101101101002121212221020112220121211022222221110111a11010111100111111111101a111111110a110111
01101011111111111011101112102212222121122122010202211111110110001101101111112021022212222222210202222021221210012111111a01110110111110111111101a001111101a011011
01111011111110111111111110212011221222120112001122111011010111100011111011021220201202002222022122202221221221110110111a10111111111010101001111a011101111a011111
01111001011111111111122112110012222011210111111112211101010011111101111101110122122102221022212122202220002111122111111a11111111101011110101111a111111011a111111
10011100111111011110110022202101211112202100111010101111110111111111111011122211022022022112221212002222222101212100111a11011111111111110101111a101010101a110011
11101110110111101111022210122120120121111122112111111101110110011111101100120101120022120221102212211001210101111111111a01111111001101101101111a101111111a110111
11101011111110111111010221211200211121211122212222111111111111111011011101111102022122222121122122211102111111111110110a11111111110111111100111a110111010a001110
01101110111101111111020212112101212222111102211101211111110101111111111011120221220220022212212022201110010111111011111a11111111101011111101110a111111111a111111
11111111111101110110010222212012120212001120211221111110111101111111111010111021112201210211112121211121011110011111011a10001101100111111011111a011011101a000111
01111110000110110111112112021002222001220112122100211110111111101111111111120221102222211222122011021212011011111110101a11011111011111111001111a011111110a011101
11111111111111111111110111222012021222122221121202220220001111101001101101121210211022110122201222022221211111111011101a11111111011111011111110a111111111a111011
10111111110101111011111211022202222021212222122002100222121111011111111011122121002211212220211211111112211111111011111a11011100111110011100111a111111011a100001
11111011011101111001020002012212222121002022222222221121211110011111111111121220221221100122222011210212111111111101110a11110111111110001111111a111110111a111111
11110111011111111111112222122222222210122220021122101112110111101111111111002222221212122021222201112011011010011111111a11110110110111111110111a101111111a111101
11011111110111101001101112102021021220221011212022100022201011111111000011011210020202121122221111112121111110111100111a11111111111000011001111a011111011a111111
01010001111110111110101111021022020221222022220222001101211110111100111011101122221002112102122112221220011111111011111a11101111111111110011100a101111101aaaaaaa
01011111011101111111111211021222221202220200220222212221111111111101101001021020111111122001221221121211200111100111110a11011101111111111011111a1010111111011111
11111111111101111111122111100101121222202202102222210212111101111111111110111000110112220001120122100112211110010111111a11111111110111111101111a1111111111011111
10101011111101011011122211221221102200222010121222002111121111111111111011112012120022112202121212000111001111111111110a11111111110111111110111a1111011111111111
01111111110101110011122122012120212022122221212012012212120111111101110110122011211200220212012120001110211011011111111a11111111111111111111111a1111011111111011
11111111110100111111111121102022222222022020222022012112011111111110111101111120211120210222012111111212211111111110111a11111111111111110101100a1111111110011111
11101111111010100110111112122002212220100222122220022112221111001110111011111022120100212202222122211100211110101101000a10111101110011111111111a1011111111110011
11111100101111111111021202120222221222222221222220110221110111110100111100110111112002212122111111021020210101110110110a10011110101111000111111a1101000110111111
10111111111111111011101221012212012222012110211222212222210111011100001111101111100111111111111001111111111111111111111a11111111101111111111111a1111110101100100
11011111111111111111122121222101222220202122222002011221111110111111111110101110111111011111111010111111111110101111011a11111101101011001111001a1111111010011111
11111010110111110110122021221122122002221222222002211211221011011111011111111101111111101111111100110101110111110111011a11000111111111111111101a1111110111111010
11111111010111111101122111101221022222221220012202212020220111111111111111111111011111111111111111011101110101110111111a11110111111111111101111a1111011111111111
11011010001011111111122210210221012002220222220212211110111010110111110111111111111111111110111110111011110111110101011a01111011111111111101111a1111111111110111
11111111001111110111121102222201222221102222102122221020210111111111010010111111110111101110111100111110011111111101110a11111111010111011101001a0011111110111111
11110111111111111011111101001012111102211221222101122102100111101111111101101010111110111111111111111011111111101111111a11110101111111110110111a1111110111111101
11110011111111101111111111002011202011011221120022201222011011011110110100101110111111111011101111110110110011111011110a11111111111111111110111a1111011011111111
10111110110111111011110111100210122110020122102210120212210011111111111011011111010111111111101111011110110111111101111a01110111111110111111111a0111001111001111
10011111100110110111111101110111022210211121211102122110121111001101101011111101010111011110111111010111101111110100101a11111101111111011011111a1110101001101111
11010111111011111111111011110222210222102112011211110000211111101110111111111110110110111011110111011111011111111111111a11010111101111111111111a1111101011111111
11110011111111111111011011101211212221101222000112212110020111101111011111111111111111110101111110111111110111111101011a11011110010111011111111a1100011011111110
11111100111110011101001100101121221121222010111112022211011111111011101011011111111111111111011011110110011111111111100a10110111011111011111101a1111111111111111
