(13,159)
(108,9)
(33,49)
(88,31)
(34,88)
(113,145)
(32,74)
(52,156)
(80,7)
(106,71)
1111001111111101111110101111111111011111100111111111111111110011011101011011101110101111111101111111111111111111110111101111001111111111111101111111101111111101
1111111111101101111110101111111101111111111001111101011111011110111111101100100011101111111111111110111011011101111101111110111111111111100111101111011111111110
0111000011111101111111011110111111111110110111111111110110000111111111010110111110111011111111110111111110111110110101011110111011111111110aaaaaaaaaaaaaaaaaaaaa
1111111110111101110111111110100111111101111111111111111111111111001111110111111110111111110111111111011111111001111111111110101001111111111a11111110101110111111
1110101011111111111110111111111110111111111100111111101111111111110111010011111001111111111111111011100101111111011111111111110110111111111a01110111101110111111
1110111111010111111011110111111111110110111111111011111100000111111011111111111011111011111111110111010111111111111011011001011110101011101a01111111011111111111
1111111111101111111111111111000111111100111111101111101011110110101110111111000011101110011111111011111011111111111011110111111010110111101a11111101110111011110
1101010111111111111111101011110111111011101111111111011101110111111111110111111000111111101111111111101101011110111111011101101111111101001a11111111101111011111
1101111111111011111011111001111110111111011111011111110011110111110010111101111111111000111101111011011001101110111111111101111111110011110a11111011111111011111
1110101111111111111111111011111111111111011010110111111111110011111111111111011101101011111110101101101101101111111111111110101111111111011a11111111110111111111
1111111100101111101111101111101111111101011111101101011010111111111111111111011010111111111111111111011010111101111011111111111111101111111a11111011110110110111
0111111111011111100110110111111000111110101111101011011101111011110110111110011101111110111110111111111111101100111111111111111101011101011a10110111101111111111
1101011111111111111111111111111000111010111011101101110110111101111100011111111111010110111111110111101110011011110111111111110011111111111a11111111111011010111
1111111111111111111110111011100100101011101111111111111111111101111111111100111111111111111110001111111101111101011011011100110111101111100a10011010111010111111
1111111101110111001110101111011111010010111110111001101111111110011111111111011101110111111110111011111110111110111001110111000111111111111a01111111111101110110
1110110111101111101111010111011111110111111111011111111111111101111111111111111101011011011001111101111101111011111001111111111001101011110a11101111111111111110
1111111111011111111100111111111111111111110110111110111110111111101100111011110111001011110101110110111101010111110100011111111111111111111a11111101101011111111
1111010111111101111110111110110101111111110110110011111111122221121120211210212212210111111111111111011101011110111110111111101111110111111a11111111011111110111
1111011111111110111111111111111110100011220112212110221212221212112020111221121122221102111111111011011100101111111111111111010111111111111a11111111101101111111
0111110111110101111011011110111111221120120121102211100221120100011011110021212122222012202110222022121110111111111011101111011111111111111a01111111111011111100
1111111110100111111111100111111111110212202111101122202011120202120221110222201202022222201000112200201101111111111111110111101111011011111a01110100111110111111
1111011111111101011010101111100111222121110020121211212011222222010201222222100102010221012021221121112010110111110110110111000111011111111a11110111111110111110
111111101110001010110111111111011112011aabbbbaabaababbbbbabbbbbbbaaabbaaababbbaaabbabbbbbbbaabbbbaababbaaaaaaaaaaaaaaaaaaaaaaaaaaaaaaaaaaaaa10011101110101111111
111101110011111111111101011011111122002b222020021121122101220201221211121022222011222112122122122212222101011111111111111101111111111101111101111101111011111011
111111110111011111111110101011111022022b210212211220022211222020220121122201220221222220122210021022222101101011011111111101110111111111101011111111101011111111
101111111011111010111111111011100002122b11222222222012221112122220121222022220220222220221200122222122110111111111111010aaaaaaaaaaaaaaaaaaaaaaaaaaaaaaaaaaaaaaaa
111111011111101111111111111111111112110b00121021101221121022120021101121222212220212202200122022200111010111110111111101a101011101111011111111001111110101011110
111010111101111111111011111101111112020b21212102220010211122212122102220222202200221022221121221222211111111111110011111a111111111110111111101011111111111101111
111100111111111101111011011111111102211b10021221212212112022211121222101200022102122222221010110212010210101111111011111a111011101111101111111100110111001111111
111011111111111011011111100111101112010b11020000111121110201112211211120122220122221201221221111111101211111110100011111a111111000101111111111111111111111111111
011111111001111110011001111101111102001b12222002121012212002112012212102122122222220122220111110102220001111000111111101a111111101101111010101101101111111101101
011111111111101111111111110110111122122a20112111001220200222022010021012222120022222222022022222100211111111110111111011a111111100111011110111011111110111101011
111111111111111110011101111111111101201a21101110102120022201222221222112220222222222222221102201212102011100111101111111a111101001111111111111011110111111111101
111011111111110110011110101110011111210b22212221221012221222021011100201121202202221120001001110011202110110111111111111a011111110011011111111101111111111111111
111101111011110101101111111111111121121b01102121110020122222022221111211221202220222222220220220122212011111011111110111a111111011111111101110101111111010100111
111110111011011110110101101111111001120a22202211212111211121012222101210221122212222222122010121122122101101101111111111a111111110100001111111110101111101011111
011110111011111111011010101101111112102a12102111101110101211020202222011211212222112012212211222222202211011110101111100a111111111111011111111101011111111110111
101110101011111110111111111101110002021a20110111222212120202202212012122221002002222222020111122220111111011111111111110a011111111111111111112012102101111211112
101011110111111111111111111011111011211b12210021222022111120212222012020202212102021222211210222102020111110111111111111a111101101111101111100110112000121101112
011110111110010011101011111101010111000a22101011102201212222122021120112111201220222122221011112110222011011011111001101a011111111111110011111110102220222212212
011011110110011101101111111001101120200a21112122121210202212200210002220202212220102221201220100010122111011111011111110a111110111101111111110021101001022212222
011100111011111101110101111011010122121b12120011020020202122212201112211120222022121122220201211111222211110101011111111a111111111111000111111022012221222121220
aaaaaaaaaaaaaaaaaaaaaaaaaaaaaaaaaaaabaab10220202220112221222220011201210122221022202102221220222000222101011111111111101a011101011111011110112221120221220210211
111111111111111111111111111110110121211122222201021212000120121022122011222000222222201212212022121120111011111111101100a111010011111101111112220121220202221111
111111111011111011011011111111011122120222111210100112002222122012222121122021221022222012112220202012101101111111011111a111110111101111011111112222220201202101
011111101111011111111111111101111111120011022122102222021122221222201011020202212012222202212000212222111111111110110111a111110111111111110012122102122202101121
aaaaaaaaaaaaaaaaaaaaaaaaaaaaaaaaaabbabbbbbbbbaabaabbabbababb222211122222221122102112222122121122001002110110111110010111a111111111111111110110222011222112201111
11100111111111011111001111111111112212120220212122021221121a211010110001110101012211112212221120121111111011011111111101a001111111110011101110222121022022221202
11110111111011111111111111110111011101111111111011010100010a101111111110110000221202021200021102111202111111111111111111a110111011111110001112210221122102121122
11111001111111111011101111110101111111110111101110110111111a111111110111011110111011010111111101111111111111111000111111a110111100110011111110210121111102120121
11111111111111110011011010110101111111111101101010101111111a011111111111101101111101001111001111110110111111111111111111a111111110111101110111211222122211120102
11111111011110011101111111101111111111111111111100110100111a011101110110101011111111111111111000101100111111111111011101a111111101111011110111102122021101011101
11011101111111111111111000111111111111100111111011101110111a101101101111110111011110100110111111101111101010111111010111a111111111011111000112122112220200110221
10111110001111110111011111001111110110111110111111101111110a011101111100101111110111111111111111111101101011111111111101a111111110111010111112121122122222001102
01011101111110110111111111111101111111111111011111101101111a111111111111111111111111111111011011111111111001111111111100a111011110011111101111112001112220222012
01111110111111111101001101010110101111111111101111111111111a110110111111111111111010111111110111101101111111111011111110a110111111101111010110220020222211122122
11111101100111111001110111111101111100111111110100110101111a101111011101101001111111101111111011111011111111111111111111a101111110110010111112012210101122111012
10101111111110011111101001111111111111010111011000101111111a101110101101011111101011111011010111101111111011111111101111a111111101111011111112021121202121002210
10010111111011111111110101111101111111111111111110111111111a111000111101011101111100111110111111111111101111110111111111a100111011111101111112120222122002111022
10100010110111010111000101111110011111111011111111111111110a111111111011111111111111110111111010110111111111111111111111a111111111110110111111212111110120121022
11110011111011111111101101111111001011111011011101111111111a110111001111111000111110111111010111111001110111111111111111a111011111100111111110111112220212022210
10100111111111111010110111111110110101110111111111010111111a101010010111111111001101111111100011010111011111011100110010a100010111011111110000222120221210211222
11011100111111111111011111101111111011111111111110011111100a110110100110111110111111111111111111101111001111101111001110a011111110111111011112221120221220121121
10111111001010000101111111111111111101111011111011111110011a111111111111101111111011110111111111011111111111011111011110a100111110111111110112122021021201121121
11111011110011110011111011101111111111111111011110111111111a110111111010111111101011111111111101011101111111111101110010a111110101111101111110121222102001110122
12111202102212001000121011111111111110111100101110101101101a101111111100111101111111101111011111111110111011111111110101a111011110011111011011212102011222211210
aabaaaaabbabbababbbbaaaaaaaaaaaaaaaaaaaaaaaaaaaaaaaaaaaaaaaa111100111111101101011101111011011111110101111011111110101111a111111111111111111111212121202212201121
121222121202112001122101111111101101111111111111111101101111101011011110111111011011110111110111100110110011111100101101a011001101111111011111011101110111100111
211212210102212201112111111011111111110001111110111011011110111111111111101110111111111111111111110111011111101111111110a110111011101111101101111001111110111101
222222222112111222122111011101111111011101111111111111011111111110111110111110111111111100001101111110101111110111111011a011110101111011111101101111100111111111
220211221112212122210111111011111111111111011101011101011111110111111101111110010010011111111111011111111011111111101001a111111001111111111111101111111111100100
120111120212212122100201111010111101011101111111111111111111011001111011111010101111111110111111110111100111010111101111a100111111001110010010011110111111011111
112020121212022012210110110111101111111111111111101111101101101111111111111111111110110111101011111011011110111101111111a111101001001011111011111110110111111011
201012111202121122200212210120122202022201211211110100111111010101111111111111111101101011111111101011110111111111001111a111111110111011111111111111111111100111
012212102220101122221211010220222112221212220211111111011011111101111111111011110111101111010110110111001111101111111110a101111100101111011111111011110110111111
201222100121012010121212222121021220020111020001111111111110000111111111111101111111111111011110111011011111111111111110a111111101010111011111010111011011111111
112211022201222202002211111102121201211212211111110111110101111111101001111100111111100111111100101101101111111111110101a101110111011110010111010011111111111101
122102122212022121212201112220112100011020211211111001110011111101101111011110100111011111101111100111110111110111110111a011101111101111001011000101111101011110
211211212201220122200111211111021102111121111211101101111010111101110111110011110111111010111111110111111010110011111111a111111101001101111111101111101101001101
100020211200021122222221221112201012110100112211111101011111111110111011101110110111101110110101111001000110111111101101a011001011101111001011011101111101011111
202021222022221222220212100012222010022211022111111111010100001111010111110111111111111110011111111111011111111111111011a101111101111111011111111111110111011011
112111122212121122220212111112120122200000202111100111011111100011111101111110111111111111101101110111111111111111111111a101110101111101111110110111011111111111
110112201222202021120121220221111210121222021211111111110101111110111111111011111011111110111111111111111010111111111101a101111101011111111010111111101111110111
100122202121112112222200222112211011020121002011011111111111111111111100111111111100111111101110111111111101111110101111a111011110110101010111010111101101111111
120022211221021220122201200010101121112212012211001111111111111111101111110110111111111111100110111111111111111111101111a111011101101101101111011111111011100111
2212112221110101221221012211011022210110120122001111111111011111111111111110101110111011101111110111aaaaaaaaaaaaaaaaaaaaa011101111111111111111010101111011111110
2111112112221212220222120111210211002102111012101111011100111111100101101111110111111110010111011111a10111111111101111111111101011011011111101111111111111111111
2201220220210221222101222220111021102212200201101111011101101110111010111111110111011111111110101111a11101111111111101111110111111010101111110011111111011101111
2212221222002112002120111222220222112222111122101101111100111111111110011101111111111111111111011111a11011111100111111011111111111101111010011100111111011001001
1101211011102111222221212212221011221111112111111111111101111010111111111111010110111111111111111111a00110111111111111111110111111111111110011111111111111110011
1221211212121120022212012000101122010111221221011110101111111111110011101111101110110111111101100101a11111111110011111111111110111110101111110110011101011100111
2201112121222222102221200112110112221121011102111111111112111122210112222201002212011110101100111011a00111111111110111101111111010111110111111110111010110111011
2022112021212122222212112210112021112122211202110111111111220221111121022112120101112211100111011111a11111110010010110101111011111110111010111101111111101111011
2221221222120211210101222111212222211221112222110111101121102101122212121100012000011211011111111111a11111111011111111111110111111110111111111111101111001101101
0201210210112211210020111022211102212222122212011011111100121221220002211111010102211111111101111111a01101010011101101111011111111011101111111101101111011011111
1101111111111011012111011011122210221210220122011110111111201020012110110201021212222111111111111000a01111111110101111111111101011111100110111011001111010111111
1011111101010011121221012220101100201112021112111111101120110220212122110221202121112011111100010001a11110110110111111111111111101111111111011111101100111110111
1101111111110010121020221222001222010022221221011110111112111112121211101111221021021111011110101111a11111111010111110110011100111001011111111110111111101011101
1100011111111011220110122211121110211121212102011111111102100211020102121222220221010110110111100011a11111111111111100011110001101021120121212221101211222122121
1111011001110111022202102200101112112111212122111011011121122221120122021102021110202010011101111111a10111111111111110111111111011012111120201111222011221010112
1111010010111101111102202202122011201011100221111111101121222212100121112102221222020011111111001111a11111111110110101111111011110022220222112220112110121121201
0001111111111111211212212112200202221011120101011111111122212221211211212022022122211001110111111101a10111110111111101111001111111221022121120112211201210112201
1111111010110111020011120211101211212112202020111111110122102200012222022222121211110001111111111101a11001011011111111011110111111121222201212210211221100201021
1111110111111111111111111100101101111111111111101011111022011212111202200022112101022101110111100011a01101111101111101111111111110222121220121111211112022020101
1101111111010110111111111111111111110111111111111111110020121221122221221002011110222101011101111111a11111101111001111111111101111120111121011221222202112221222
aaaaaaaaaaaaaaaaaaaaaaaaaaaaaaaaaaaaaaaaaaaaaaaaaaaaaaaabbbaaabbaabbbbabbbaababaaabbbbaaaaaaaaaaaaaaa11111101111111100101111111110220222211112112112221222210211
1110111111111011110110110110111111100101111111111111010011212022212211221211222210220211000111011101110011111111011111011110111111021100122221221201001210112211
1111101111111111110101101110101101111101110011101101101101110201222211021112111112212111111111111110110111101111110111010111111011122220212120121111112020111202
1111011101101111110111111110110111111111111110111100011101212210222011110102212221022010010111110111101011011111111011111111111101211112101111122122120211000222
1011110111111000111101111111111101111001111011110101011022121211122212110011021220120210111011101110110010111111111111111111111111121210112212211201222000211211
1111111011111101111110111111111011111111001111011010111122021221122210022220101202111111111011111101111110111111111111111111110110112022121222210211222100212100
aaaaaaaaaaaaaaaaaaaaaaaaaaaaaaaaaaaaaaaaaaaaaaaaaaaaaaaaaabbbaaabaabaabbabaaaabbbbabbaaaaaaaaaaaaaaa111100100101111101010110101010120012012212212221211212111202
101100011101101011111111111010111110111111111111110111111120122001212101011110211222211111101011111a011101111110111111111111101111211121012011121210122122201221
111111110110011101001111111011111010111101111111110100010211022201122121112211212202111100110111111a111010111111111110111111110111101101100221112112120222112121
010111101111110111110011111111011111111011101110110111011200111201202120121110121201111111001111111a111101010101110111011111111101011020110211211112021102212122
111111111011011111110111110111011111101111111010111111101220222222021101110010120112021100101000111a111101101111111111111111111111112111121211212112010111110211
011111111111001101111111010100111011111011101101101110110221202112202220122022111211221101111101111a111111011011111111110111111111010111211112112021010201211002
111111001111111111111111111010111111011111011111101111111101002222110100210001111220221010111111011a011001011111111111011111111101021002100202021211202120110022
100101111111111110111111111111111111111111111111111111112112120112020011222120221220201111111111011a111111111010111111011111111110211121211100111210210221102022
110101011100011011011111001101111111111011111111111111110222020112221221121112111111221101111111111a011011111101101111111111111111222110112001122210012211120210
