(9,82)
(116,109)
(78,146)
(85,148)
(28,26)
(94,140)
(52,99)
(17,55)
(33,87)
(33,60)
0111111111111111111a1111111110111011111111111110101111111111a1100011111111111111011111110111010111110111010110111110101011111111110111111011101011010a1101111011
1111111111111111111a1100111111111110111111111101011111111101a1110111111111010111111111111111011011001111101111001110111110011111111111111111111111110a1011111111
1111110101011110010a1101111111111110111102020121212211021022b2122111121111111011111111111111111111001101100111110111111101110111111010111011110111111a1011111111
1111100101101110111a0111001111011111100102022011111211111122b0112200021011010011111111111111110001111110111111101111101110010111111110111111111111111a1101111111
0111011101101111111a1001110111111110111121021110212021222112b1212220210111101011110111100111101111101111010010101110111000001111010110111110110111001a1111111010
1010111111111111001a0111111111111111111121111100211022112021a2200011121101011111111111101110101101011111111111001111011111111111111110111111111111101a1111010011
1111111100111101111a0011110111111011111001120011120001121221b1201102201011011111101110110110111100101111111111101110111111011110011111111110011011111a1111110111
1111011011110111011a1001011111101111111112011122101112111110a2202220021111101111111111111111011111101011110011111101111111111111100011001111110111110a1110101111
1111111011111010011a1111111111011101111110121220101110222121a2101111120110011101111111111100111010111101111111111101111101111111111111111111111111100a1111010110
0011011111111011011a1111110111101101101102122111111011211202a1011012211110111011111110111111111111011011111011111110101011111011111101111111101111111a1101111001
1011111111101101111a0111111111111110111110222211221222121211a2222121211001011111111111011011101111111111010110111111101011111111111111101111011101111a1111111111
1011111101011000111a0111111111111011011111110112101211011020b0201222021111111111111101111101110011010101111110111011110101111011111111100110101101111a0011111111
1111110111111111110a0011111111111011111111212112011220011212b0021112110111111111111101111111110101111111111111111111010011100111111100101011111011110a1011111110
0011010111102212021a2221202222122020120120122111110020112122b2220220200111111010101011111111111111111110101110111101101111111011111111111101110111101a0111011111
0111110111111120121a1211021122122111220122121212100110112102b1221022221111111101101111111111111110111101111110111111110111011111011010111110111111111a0111101111
1011101111122120122baabbaaaabbbbbabbbababbbbbababbaaabbaabbbb0101001111111111011101111011111011111010111110101110111011111111111111110011110101111111a0111111111
11011111011221112122112112001202122011112212122020211121211aa1222221221110110101111000001101111111011111111011011111110110011111111111111100111111111a1111011101
11011111011111111111102212020111222111210222112200210022121bb1202012221101100011110111111111101111111110111101111110111111111011111011010111111001110a1111101101
11111010110211222110202212121102112121100121211202212112122bb0021021111021210221212202221112211121222201111111111111011111111111111111111100101111111a1111111111
01111100111101212111022110102102201111212002222022211221121ba2121022222222200202022112100101002112211201011111011101111111110111101110011011101111111a1101111000
10011011000202211221021120121201002122121120211202022121222bb2222022222222121102221112102110211202022010110110111111110111001111111100110111111111111a1111011111
01111111011112112122201222212201210121000212102020020120020bb2122222122120022112220012101011122022220011111111111001111100011011101111111111111011000a1111111101
11011111111121210201222222221111212110020201212122122112222ab2112222121012222112112111112222021022211200111111111101111101001100001111111111110110111a1101111111
11111111111010111121012222021111111202212001110200222112221ab0112220212102210211221021021002211220211101111111111101101111111111011111111101101111110a1111011111
11101111101001102212102120122121012212022212122222222212011bb2222211122210201212111212211122102122101201100111011011111101101111011111011101111111101a1111101010
11111111101221222121221202101211211121202002222222222212222aa2201020212122220111220110010010021121212211110010111111111011111010111111111011110110100a0110011110
10111011111012122200211212121012122012212222222120012222002bb0212212220202022202111111121210112021100211111111111111111011101110111111111111011110101a0001111101
11101011111101121112220101120220222210202112221222222122222bb2012222122211211211222220011211201110221011111011110111111111101011111111111011101111111a1110110111
01110111011121022120121101212212210121212121102221022202022bb2002220212102120212212101221221001120211211100010111111101111101111111101101111011111101a1111111111
11111111111212022110211111212122112010121221222122201212212bb1222220222122222112110121102201211221222111011111111111101111011111111111111010101101111a1001111111
11111110101121122121100122222022112211022121222222222012222bb2221202022221122222112212120220010222122201111111111111111101011111011111111010111111111a1110111110
10101110011010121112211011001102121222110011112001020122210ba2112011102121201220111201212221011211220111111110111001011101111001110011111111111111111a1001011111
10001111111022012211011012022221102222222010111112021002100ab0221110222202222222212212211121012012112010101111011101111111011111111111111111111111111a1110111111
01111001011122212101211211222122121212111010021111121122201ba2000122110112211121012012112121211112222010111101011011111101111001111111111010101111111a1111011111
11110101010220101211021210201011012221021111100112100111222ba0211212000200210002222111010112112021211211111111110111111111110011111111011111101111111a1111111111
aaaaaaaaaaabaaabbbabaabbbaaabbbababbbaabbaaaaabbbbabbbbbbaabb1122120121012011211012122122122222201221101011111111101101101010101001111011011111111100a1111001011
111101111102001102212220210222211220121111101101011220122120b1001222111222221121212012101211221221210210101111110111111111111110111111101110101111011a1011110011
101111111110021212211110211011212001121101101110122211111211b1102212221121220222102220222122012022211222012022121011111111110111111111111111011111111a0110111111
a10010101110211001222102220110122212221221000012222120222202a1201212211021222122102220202020222212202200210211212101111110111110111111101111111111111a1111101111
aaaaaaaaaaaabaaaaabbaababbaababbbabaabbaaaaaabaabaabbababaaaa2202120200111211121212022222020221010121211111011212200111011111111111111110011111011011a1110101001
11111111101010202220022220110212021202222111122012121102222110002020011101110211202220222211222111101212101222021211111011011101111110111111101111111a0100011111
11101101111211212212221101222121110121221110110112210122121102112100221122202212012222220212221112122110121201111001000111111111111111111111101101111a1101111111
11111011110212002101211110120002022101211111112000220211112211112122101121220012101220201211002112121021121001022210111111011011100111011101111001111a0111011110
11111111111111111101111010100111101101111011121221122122100101212221122221222102202120202122202210212120211212212201101011101111111111111111111111101a1111101111
10111100111101101111111010111101100100101111121121111122202111112001112112212221012102022222120122221020020112212210111111111111011011110101000111111a1110010100
00110111111111101101110110101110101111111101101121212020121121221121222002221210120121022222221222200002112200221011101011111111101110111111101111111a1111001111
11100000101011110111111110111110111111100101120212222212121221201220022022210111200022222222022212220212110221101100111111110111111001111111101111111a1011110111
11110111101001111111011011111101111101111011100111111210110201111212112102221222210121110222012221212211121222021210101001111111111111111111101110011a1110101011
01111111111111110111110111011111111110111011101101111111111111111111101011010001111112201202222122022212120221222101111111111110111111111100101111101a1001111001
11111011111111010111011111111011011111111111101111101011110111011111111111110111111010221101122122111112201121222111011011011011111011011110111111111a1101101111
11111111111101111111111111111101111110111111110111011111001111011110111111011011111020110102212021212212121121012110111111101111010110111111111101111a1011111110
11011111111111111111101011111111110111110110011001011011101110111111101111110111111111111021221222112220122112202011111111001111011111111011110101110a1101011111
11110111111011111111111111111111110111111011001111110111110001111111110110100110111102211221222012002122020112111211111101011111011110011111011111101a1111011110
10111111010110111111101110111111111111101111111110011111110111101011100101111110111121222112222121021210112111222110111001111111111011111111011111011a0011111111
10011111011101111111110101111101101001011110111111111111110111011011111111011111010121021120202101202200211112110211110111101111111011011111101111111a1011111110
10111111111111110011111111011111001101011101111111111111111111111011001111010010110122111202211000211122211112021111111100100111101111111111111110110a0111111110
11011111111011111111101101111111111110111111111111111100011101011111111111101111111120122102222111212112220122121201101011111111111111111001011011101a1011101011
10101100100111111110111101111111111010111111100111111101111011011111110111000111111020111212221102221211200221111011111111110111101010111111111011111a1011111110
11111110111011111011111111111101010110110111101111101011110110111111101111111110111020212012111021210122210211211011111110011011101111111111110100111a1111111111
aaaaaaaaaaaaaaaaaaaaaaaaaaaaaaaaaaaaaaaaaaaaaaaaaaaaaaaaaaaaaaaaaaaaaaaaaaaaaaaaaaaaaabbbbaaaaaaaababbbbaaaabababbaaaaaaaaaaaaaaaa1111110110100111100a1111011111
111011111111111011110101011110111111111111011111100111111101111110011011001111101111222102121221201101012121202122111111111111011a1111111101111011111a1111110110
101011111011111111111110111111111111111111011111111101011111111111011110111111111111221210022002122010112221112222111111111111011a1000011111101111011a1111111110
111111111101001100110111111110111111110110011111101111100111110011111101011110100101200120011222202121221011022102111111100001111a1110110011111011111a0000111011
111011011110010111111110111110111011110101111111111111101111101011111111011111111011210110121211222212012220210112110111011011111a1121221222222122112a2000200112
111110111001111110111011011111110110101111001111111111111011111111111110111011111111011111111222220012022211121011110101111111001a1200021112011002211a2200110112
101111111110111011111111111110011111111101111110010111010101111011111100011111111101022211220120212200201100101121011011111101011a0112202002120020002b2012221221
011110111111011111111101111101001111101111110011111111111110111111111011111011111010110211222112120121100212122112111101111111101a1211110210221222201b2222111022
011111111111111101111111111110111101111111111111111111111011011110110101111011101110111110111010111111111111111110111111001111100a1220012112102012101a1212212222
011111101111111011101110011100110111111101111111111111111101110110111111111111101011011111111111111110111110101111010110111011100a1200012202021220111a1121122112
111110110100111111111011110111100111011001110110110101111111011111111111111011101101111110110110101011111111111111111001011111011a1212221202212010210a2222211222
111110101111101111111110111101111111111010111111100111111011111001110011101011111001110101111111111111110011111111010011111111111a1212220222221222021b2220002222
111111111111101111110110111111111111011111110011111101111110111111011111111101111101101111111100011111111110011111110111111111110a1222212112022211222a1212212121
101111111111101011111011110011111111111111111111111110111111111110111111010001011111101101011111011101011001110111111111011111111a0122202002022022222b2222222000
111111111110111111111111110111110101101111100111010111111111111111111011111101111111010110111111111011011011101111111110111011111a1212122022222022011b2212111212
111110111111111111011011110110111111011101010111110001111011101111101111111110111001111111111111111101011100101110111111111111111a1000221122221120020b2012022211
110110011111111111011100111111000101110111111111010110111111001111111111011111111111111010111011111011100101111011111111111110111a1222221220101201110a2011122111
101111110111111110111111111011110110110111011010111111101111111111101111101100110011111111111111111111111111111100110110101011101a1220022122021221221a2222202220
111111011101111110011111110111111111011111111101011111110011100111011111110101011111111101011111111111101010111110111001101101101a1222212221222220222b2222222012
111111111011111111111111101001111111111011101111110111111111111111111111011111010111011111110111111111011110110111101111111111111a1200222212222202202b2011202202
101011111111010101111101111101110111001001111011111101010111011111111111111111110111111101001111101111101101101111111000111111110bbbabbabbbbbbbbbababa2222222120
0011011110111110011111111111111101111111011111011110111111111011111111101101010111111111010111111101111100111110100111111111021121022111222022221220202202222122
1101111101111111111011111110110111101111101110110111011101101111111011111111111111111111101111011111011111110111111111101100122221002020222220222222012202122212
1011110011110101111011000111111011111000011011011101011101010011111111111111111111111111110101111111111011111001110001000110101202122221222222222202220222121022
1100110110111111111011111111111111111111011011110111101010111111101111111110110110111001111111111011111111111111111111101101122201221222222222210212022222202122
1111111111111111011010111111011111111111101110111011111110011111010100111101110010110011001110111111011011111111111111111110122222112022222202202222022220120211
1101010111011111111111110101001101011001011111111011111111111110111111100111111110011110011111101111111001001010111111111111110222122212222221221012122002222201
0111111111111000111111110010101111101111111111110111110111100110011011111101111110111101011111111110110011111010111111001111122222122122020022122100222222220222
1111011110111011011111110111111111111111111111101110110100111111110110101100001111111111111111011011111011111111110111111111121221121222122122022222222201211200
1111111011111011101010111111110111101111101111111111110111011101111111111111011111111111111011111111111111111101001001111001122201221022022221022202202012012020
0011111101111111110111111111100101001111111111011111111011110111011111111100111111111111111111111111111110101111011001100011120022100212112221201222122221122220
0110111111011101111011011111101111111111011111111111111111111111001111111111111101101111111111011100011000001111011011111111112221022212222222012222200220222021
1111111100011111111111100101011110111011111111011111111111111110111011111011101010011111010111100111111111111111101110111101111220022020021220222220212222112222
1101011011011111011011111111111100011010111001110100110011011111011110111111011111001111011001101110101111101111111011111101120100222202201222222022120222022222
1111111101101111111001101111111111010111111101111111111011110110111110111110111110111111011110111011111110111110011011101110100121212122022212022022122210110210
1101011111111111011111111011110011010010100111111001011110111101110110011111111111111111100110011101111011111111101000111101121112011212222222212102221002222022
1111111111111110111111111111111100001011011111111110101011011111001111111111011111111111111101011111111111110111011111110100122111122122222102221221102212221112
0111111010101111101010111011111001101011111111111111111111100110100111101111011111011111101111111111111111110111111101111101122102121220222220201022122220212110
0111111111111111111111001111110111111110111111111100111111111111111111101111111101100110111111111101011011111111111011011111112201212212222222202111021212022110
1101011111111111111111111011111101111111110111011111111011011111111111111111111111111011110111111111110110111111111101111100122100202202002122220202210222210111
1111111111001111111111111111111001111111111101111111111000111100111011111111101110111011101111110111111111111111101111111111111200112212222102222222022222212021
aaaaaaaaaaaaaaaaaaaaaaaaaaaaaaaaaaaaaaaaaaaaaaaaaaaaaaaaaaaaaaaaaaaaaaaaaaaaaaaaaaaa0011010111111000101111111111111111111111111122011200212111212122122002111111
01011101111010110011110011011111010011101111111111111011111100110101111111110111100a1101111110111110011111010011111111110110121100222202221012201211221212111111
11111100111111111111111111110111111111111111111111010111011111111111111110011111001a0001111111111111111111010111011111111011102011200202112122122211011221201010
11111011111001111011111111111011110111110111101101111011111011111111111111111111111a1111111111111101111111111011111110011011102221211120110212120001121220100111
11101110111101111111001111111111101011111101011110111011101001101111101011111111010a1111101111101011111101100111011011111101100102211212022101211211020122011111
11111110111111111111011001111111110100111111111100100110011111010111111110100111110a1111111111111111111111111111111111111011112221222021002212202022202012101011
11111110110101010110011111111110111111101111110101010101110110111101111010111111111a1111111111111111111111101101111111110111111122102020122211110121011220011111
11111110110110101011111011110111111110111111110111111110000111111011111110111111111a1111110111111111111111111111111110111101010021122212201110112201101222211011
11111111010110111010111111111111111111111010111111111010011111111101101111111111111a1010111011110111001011011011101111111101122201112010202220220211022102110111
11111111110011111110101111111011110101111111010111111100101111101111011111111111111a1111111111101110111011111111111111001011101111111111111111011011101111011010
01111111110011111111111111111101111111110011111011101011111101111111111111011111110a1111001111111110111111101111011101111001101111001101111011111011010111011110
11111111111100100111011110110111111011011111011110111100111110111111111111111101111a0111101111011111011101110111111111111111111111001111111011101101110111111011
11111111111011111111011110111111011111111001111111010011011111011111011111111001101a1011101111011111110111111111001110110111101111110111111011111011110111111111
11101111111111111111011001111111111111101111111011111111111111101110100110111111111a1111111011001110010111111111101101111111111011010111101111111110011100111111
11111111110100111101010011111101111111111101111111111111110111110010111110111111001a1010011111111111111011001101011011111110111110101111101110111011111111010111
11101010111101111111111111101110010111111101111110101101011111011111110111111111011a1111110111010111101111110111111111111111111111111110111011001111011101111111
11111111011111111111111111101111111011111111010101011011111101111101111011111111111a1110101101111010111110111111111011111111111011011100111100111100011110011111
11111110111110101111100010111111011111111110111111111111111010111100110101111011111a1011101111110111001111101111111101110110111111110110101111111001101101011111
11111001101110101111010011111000111011110111111110111111111100110111101110111111111a1001010110011111000111111111111101011010111111111111111001011100110101110111
11111011111101111101101111101111101011011110110111110110110010111111011101111111111a1111111111110011110101110111111100101011010111100110100111111101111110111101
