(97,146)
(114,1)
(81,49)
(71,27)
(70,133)
(29,53)
(6,4)
(29,62)
(54,107)
(116,45)
10001222112121012110111011000111100111011111111110110101111001110111110001111111a11111111111111101111011110110111101111011010011101111110111011011111a0010111111
21211011121212020101100111111110011111110101111111111101111111111011010111111111a10111111111111111111111111101111011001111011111111011110101000111111a0111011111
20001120022221021221110110110111101101100101110110010111101101111111110110010111a11011100111011111111110111101011111011111111010111111111111111111111a1010111111
11102111122002121120110111111111111100111011111010110101011101110111111110111010a00111011010010111011111111111111001111111111111101011111001101111111a1111111110
20212212221121211221111111111010111111111111011101111111011111011011111111111111a11011110110001111101101111110011011111101111111111111110110111111111a1111110110
02201111212210022220111111111111111111011111111101110111000101010111101111111011a11111111111111100011111111111111111111110111101111111111110111101111a1101111010
12122211211102122220111110101101111111111110111011111101111011010011111111111111a11111111011011111110011101111111011010010010111011011101111110001111a1111111111
11222211222121122221101001110111110011110111101100111111110111111110111111101111a10111111110111110101101111110010111001111011111011110111111011111110a1110110111
12101222022110220020110111111111111011011111011111111111111101111111101110011001a01101111111101111111101110111111111100111111110011111111111111011101a1111111111
21201022112021110110111010011111111001111101101111111011111101111111111101110101a11111110111011111101110111111111011010110101111110101111111111111111a1111101111
11111111022011021221101111111111111101111111111111111110111011011011101111111111a00110110110110010111101011111111111111111111111110111011111110110110a1101110010
21101202021211211221000011111111111111110111111011110101001111111011100101011001a11111110111111011111111110101110111111111111111111111101111110111010a1111111111
02111121112101100121111111111111111111111111001100111111100011100100111101111101a00111111001101111101011101011101011011011110111011111111011011111111a1111011001
11201010212220112211010111111111111101111100101101111111011111111111111110110111a11111111101111100111111111011101101001101111101111111011111101110011a1111111111
11011000122122122121111010111111011111202012021201122222122222202222220022220110a11111111111011101111111101011101111111110010001111111111110101111111a1111111111
10110101122221111121100111111111100011112201222210222012220202222021011212110100a11111011110111111111111111111101111111111110100111101111111011110111a1011110101
22221222220201111211111111111111011011011112112210222021022221221221011212221111a11100111111111110110111111111111011110011111011101111111111111111101a1111011110
12122021112101011111011001111111011111112111101122210101221222120002122122211011a11100111001111111110111101110111111001111111111001111111111101011101a1111110111
11000111211210212121110111011111101011122110210222121222002220102121201102202110a10110111001111111111101111111011111111101110011111111101111111111100a1100011111
22012010111000111121111110111111111111112111111122222220022221222221100001211111a10111011111100100111111111101010100100111110010001111111110111111110a1111111111
aabababaaaababbaaaaaaaaaaaaaaaaaaaaaaaabaaaabaabababbbbbbbabbaaabbbbbbb212111111a01111011001011111111111011001100011111011011101111110101111111111011a0111110111
0110011110100011110111010110111111111022120112220220122122222220121221a121202111a10111111111111011011111111111111111111111111110111110111111101111111a1010001111
1111101110111101110111111011111101111020221112221220222112222222222222a222211111a10010101111111101111101110101001111111110111111011111111110100011111a1111111111
1101111111111010101011111110100111101121221122122122022212211222222221a112110111a10100111110100111111011001110110111111110111101111110011110101010111a1101101001
1101011011111111111110101101101111011121001200222211022222221221011212b100211010a11111111011000101100011011111111111101111110011111011011110100110111a0110111101
0111000100111111011011011110100011111012012211200222122100212101212211b201101110a11101111111001001111101111111011111101111101110100101101111111010111a1111101011
1011101111111111111011011110101011111121102121121222220021221222221222a122112101a11010101111101101011111111111110111111010111111101111111011011111011a0011111111
0010111011111110111110110111111111111102002111012211122201212222202011a112222111a11110111011101111101101111110101111111111111111111111111110101111011a1111111011
1110111101101110101111010111101110111121100021212222222122120212221210a200110101a11101111111111011111101111110101111011111110101111111011011101111111a1111011001
1101101101111111110111111111111111110111021121021222022210201212202122a211121001a11111011111110111111111111111001010111111111111111111111111001011111a1110111111
1011111111111111111111111111111110111120202212212212220202022120200110a112110111a10101111010110111111110111111111110101111111111111011111011110111111a0010101110
1101111100111111111111111111111111111121221212101022211210221012222221a112212011a11101101010101011011111011011110111111011111110011110111111111111111a1011101111
1100111101011111111111110111111101111122110012022201210222211112211210b101121111a11111101011111111111111111101111100111101011110101111011111110111011a1111111111
1111110011110111101111011110111101111100021121222021202202022202100222b222122111a10111100111011101001111111011111110111011101111111110110101111111110a1111111111
0111010101111101101011110111111111111012222012020011122221222122221202a011102111a01111111011111101111011111110011101111001011110111111011111111110111a1111011110
1101111111111111111110010111111111111112022002002122220202102021202212a222212011a11111101101111101001111110101101100111111011111111110111111010111110a1111111011
1111111111111111110111111110111111101022211212201221222222222222202211a102112111a00111111110011111111111011101011111000111111101111111111111111111101a1000011011
1111111110111110111111110111101100111101111220222212020211222120221001a022211110a10111010111101011011101011111111111111011111111111111111001110111101a1111111111
1111111011111110111111011111110010011110202221221120002221211122222222a210122111a11111111111111111111011111011101111111011001011011110111111011111111a1111111111
1110111111101101001111011111111111110101200222022221222201212220120220b101202110a11011111111122220112020221012001222021112110101111011001011111110111a1111110011
1111110111111101111100111111110111110021210101011222222221222020202212a202011111a11111111111111120221221102100102122111122101111111111111011111111011a1111111111
1111110011011110111011101011110111110101122101022120220222222220222211a202201101a00110101101121121212222121222220112212122101111010111111111010111111a1111111111
1111111111111111111111111011111111111121210122201220222101222012210221b021121111a01001111111112111110122221122212121212122011011100111111111101111111a1011010011
0100111010111100011111101011111011101011122222202202110222002221212222b202121111a01011110111211221122202112022022112012202010010011010011111111111011a1110001110
1111111101111111101111110111110111111111100011111111111111111111011110a111011111a11111111100212101112212110022112110221111111111001111111101001101111a1110100101
1011110001111111111011011111111001110111111111111111011111111110110010a100111000a11100111101022221022212102112001211202120011111110011101111111110011a1010001011
0011111010101111111101111111110111110111111110111111111101111110110111a110111111a11111110011212222110021100212121122012211101110111110011110001011101a0111011111
0110110111111111111111111110111111001111111111111111101111111110111111a111111111a11111111111122222212221121012212210112122111101110111111111111101110a1101111111
0101101101111111011111100111111110111111111111011101011101101111001101a011011100a01011101111002222212121211211001211222021111101101011111110011111011a0011111011
1111101111001111011111110111110111001011111011111111111111101110111111a111111110a01011111111212111222120122121210112100210110111100111011111011111010a0101111111
0110111010111011111111111011111111110111001101101010111111101111111111a111111101a11111101111121221112011021221110121122102110110111111101111111110110a1111111101
1101011011111001111111101011111011011111111001110111010001011100111100a011111110a11101101111020122022212020010101121220122111001111110111001011111111a1111110101
1101110010011011111111111111111111111011111001111110011101011111110011a111111101a11111111111212211111212102122202102102121001111101111111101110111111a0111101111
1111111111101011011111111111001101010111111011010111111110101111111111a111111111a11111111111120011011122220211121100221111111111011110110111111110101a1111111111
1111010010011101111111001111110000011111110111111111101111110111111111a011111111a01100011111012202021221210220111222021210110011011111001110111010111a1110111011
1111111111111101111011111101111110101111110011111111101111011110101111a111111011a11101111111212200122221201222012021022222202100111212121210212202011a1101111111
1111111100011212221202022222122212100211221011101100111111111101011111a111011111a11111111001102222002202020022212112222111221111112100010020112122221a1001011101
1111011111110201222211111111210211221212101111011101111100111110111111a111111111a10111111110212212121101112100121111111222010021221112112011112222011a1111111111
1111111100102021010122202122020222020222110110111111101111111111101100a111111111a11111111111011120111102200220010210212100111112111210010201211221121a1111111101
1111011101112111220220112212011122020012011111011001111111111110111111a010111111a11111111101021011120202122111122120220210220222222010022200111122111a1111111101
0000111111111110210001200011222011122000101100111111110101111111111111a101101111a01111111111120021012212200210121121122212202211110012110001022212201a1011111111
1111111101111122221112111221212002011122121110111111110111011111111111a111111110a11011010111211212012002212010220012122102022220022211111211201201221a1110111001
0111111110101012111011111222221211211101221011111111111111011111101110a101111111a11111010111211101211100201122101122212021202000012211120222122112221a0101111011
1011111111112100221121001212021222220122021111111110010100110100011111a101111111a11110111111102200100120001210122201101222121201222121110022112212210a1111111011
0111101111111212201111212020211120211020021110010111110111111101101111a111110100a11111011011112110112110201222112101122221212001201222222001212112011a1111011111
1101111110102202101112122122001102111020221110111111111000111111011010a111011111a01111101101220222122120211112111012002222212011212021211022110212120a1110111110
0101110111110012112120002111221012001122022021111222102111111122110111a010111111a01111111101121120202112021222121112121212212011112102211222222120010a1111111110
1110111111112221000222201021221122022120022111120112022222022212011110a111011111a11111111111201202212122102112112000122220212000012020112220102201201a1111111111
1110111011112101212211222202121111120220201002110011002222111220111111a111110101a11111110111222221200200211201222111222122210201012202012112210120121a1110111111
0111111011012222112111022221220100111021221011012102112122202221111011a111011011a11110011101011111111110111011111111010222112021211102222112111220211a1101011111
1111111011011212121201120221121121022222222112012122112111210212111111a111101110a10111111111111011010111111110011110010110212010021122121022221121011a0111001011
1100001101111201221220001220122101222122101220121112020101012112111111a110111111a01111110111001111101011101111110011111012221120121222122121012102111a1101101011
1111111110102020211121221212201010212120121110022011221110121111110001a110111111a11001111111100110111111111111111110110211011122112101102120201001220a1101111101
1111111110112022101211102202220010221222212112011021110122122212101100a010011111a10110111111100110111100111111011111101112021101222110101110102121111a0101011111
0111111111112222122bbabababaaabababbbbbbabaaaaabbabaaabababb0220111011a101111111a11111011111110111111111111101001101112110221211001010211122221220110a1111110111
1111111111111100200b121121121222210022221202212112111120010a2211111011a101111101a11101111111101111111011001101111111112122211111222221021110121020121a1111111111
0101111111101022202b122111121112120202222211111111020201222a1121111111a111111011a01110111111111111011011110000011110111221221112022111121102121102110a1111101011
0101111010111112012b021112122211210202210201121211111012112b2221111110a111111100a11101111101001111110011110101111111112010102221211100100120121112121a0111111000
1111111001102121020a121111102111110221121022121122111211212b2220111111a101010110a11111110111011111011111111110111111111112212221102102212101121220121a1111011011
0101111010112212121b121011211021111222112101211002210111001a1202111110a101110011a10111111111011011011011001101011111112112120022111222122021212020120a1111101111
1111111010102001210a221202010221220021202221122201102221102b2122110111a111111111a11111110110111011111111111111111111112121210101112200111122122211001a1100011111
1111111110011012220b012122111212000222012212110222012221011a2011111111a111110010a11011111101111111010011001111111111110211102021200121122221221122111a0110111101
1111101101112012202a222002120122211220011200222211222022122b2100111111a011111111a10101011111111111111111110111111011012120201221202122012111122212101a1110110111
0011101010111022122b221021021021212202221021222111221010211a0221111100a010001110a11111111111111111110011011001111111111001110211111101120200011222021a0111110111
1011110111112102212b112121011222002221202201121210202210201b2222111001a011111111a10111011101111011011110101011110111110200122212211000110112220210101a1101111111
1101010111111110110a122111112121012222200212022211212102120a2110101111a111011110a10111100110111011111011111111111111110111111100111101011111111011111a0101001110
1111110011111111111a010111111111111210222202021221200122221a2222110110a111111011a11111111101111011111101111111110111110110111111011110011111111101111a1110101011
1111001111111111100a011111111111111112201112210212122222111b1111111111a111111010a11000111111110111111111010111111111110011101101101101111101111100011a1110110010
1011011011101111111a111011111111002110001012110101222000201b2201011010a111111111a10011111101111011111111111011110111111101111111111110011110101110111a1111011111
1010011011001111011a110111011111102120211211212220122101111b1121111111a110111111a10101011011111011111111111101110110111111111111111111111011111111111a1111111111
0111111110111111111a111101111111102212121221110111012121021b2211011011a001111111a11101111101111111111011111111101111101011101011001011111101111111110a1111111111
0110111110111011111a111101101111111122001122012122120112222b2012101111a011111111a11111111110111111110101111111111111111001110111101111111101111111001a1001111111
1111011101111111111a111111101010100122221011022220211110212a1222011111a111100011a11101011111111111110101111111111111011111111111001111011111110011101a1111111100
1111111111111111111a111011111111110200212021120102021021202a2201111111a011101011a11101111100111100111011111011011101111010111101111111111111011001111a1111111111
aaaaaaaaaaaaaaaaaaaa111111111101110111012121102021222122222a0122111111a111101111a10111110111111111111101111111110111111110111011111001010001111111110a1111101011
11111111111110111011110011011101110102122112112112201110211a1120110110a111111001a01011111111111011011111111011111101110101011111111011111110111111101a1110101100
11101111101101111111111111011111101111111111111111111111110a1111011111a111011111a10111110010110101101111111111101101100111100011101100111111110111111a1110111111
11111110111111001110111101111101011101111100111111111011111a1110011111a111011111a11111111111111011111111111111111111111111110111011111111010111101111a1111111111
11111111111111011111111111111101111111111110111011111111111a1110101111a111111001a10110101111011111111101111111100011111110011111011100101111101111011a1111011110
11111111111111101111110111011011010001011110111111111111100a1111110111a011111111a11101111011101011110111101011101111111111011010110111111111000011111a1111111111
11110111111111011111111111110101001111011100111011111111000a1111111101a001111011a111111111111111111111111111111111110110101111111aaaaaaaaaaaaaaaaaaaaa1111011011
11111010101111001011101111111111222110121120221111201112222a1111101111a111111011a111111011111111111111111111101101011111011001111a111101110101101101111111110111
11110111111010111110110111110100110212121121021011202220112a1011011111a110111111a101111111011101001111111111001111111111011111011a110111111011111111110101111111
11111111011111111001111111111102112102211121111112021122122b1011111110a111111110a011111010101101010111001111111111111111111111111a111111101110101110111111110011
01111111111011011111110111111111210120111222121211221221012b0111111001a111110010a111111111111111111110111111111111111111111111010a111111111011111111111111110111
11100100111111111111101111111122120001221221121211020121122b1111111110a111011010a110110111111111110111111111011111111111110001111a110111110110101111111111111111
11111011111110011110101011000012010201221212022221022211222a0111101101a101111111a100111111111111101011111111010101110111111111111a110111111110010111100011001111
11111111111111111111111111111122102111121212111022120122022a1111111011a100111111a101111111111110110111110111101010111110111110011a111111110011111111101111111111
11111111111101111110111111011120211221212212211201020202202b1110111111a111111101a111111101110111110010110111111101011011111110111a111110011110111011010111111011
11111111111111111111111111111111121111021022222102220012021b1111011111a111110111a111111111101111111111111111111101101011111111111a111111111111100110110011111110
11111111111111110111111111111011221121011010101211112202112a0110100111a111110101a101111111111110111111010111001111111011101111111a110110110111100111111011111100
11110111111111100111000111111112210220222102000022101111122a1110111111a011111110a111111010111111011011110111111111111101010111111a101011111111100110110011011101
11011011111110111111111011111121210221211222021201122121202a1111101011a010111101a101111111110110010111110110111111101111101011101a111111101101111111111111111110
11111111110111110101110011111020111010022210212222100102111b1101111011a111111001a100110110111011011111011111111111111111111001011a111111110111111111111101111111
11111011110111101111001010011021222121222112221112200111112b0111011111a111111100a111011101100111100111101111111101101101110111110a111110011011111110111111011100
10111111111011110111011001110122212011002002011201122120101b1111111111a111101111a111111111111111111111111111110111110001110111111a111101111111001111110111011011
11001111101011011111111111111110102211120012021122120211021a1111111110a001111101a011111011111011001011111111011111111111111110111a111111101001111110111110111111
11110110111111111010110101101111011220221112212021221212202b1111110011a111111111a011111111111101111011110011001111101111011101101a111111011111111111100111110111
11110101101111101111111111011012202111021211122102111020010b1111111111a101111101a111110111011100101011111011111111011110101011101a110110100100111010111111111110
11111110110111101100111111110121112112221111111211222120221a1111100110a100111111a111111111010111111101111111111111111110110110010a101001111111111111110111111110
