(8,140)
(110,78)
(47,97)
(51,53)
(87,45)
(100,27)
(70,56)
(5,11)
(108,157)
(33,81)
21122202000b122220111110221111111001111101101111111a1111111111111111111110110111111a1111101001111011111111111111011110110a10111111101111111111101111110111101111
21021211000a212211202220221111101111010101111111111a1101110111111011111111011111100a1011111111101111110011111011110111011a11111111111111111111101100110110011111
10122101200b122211112122020000111111110111111110000a1111101111111111111111101111010a1111111011011011111111110001111011111a10011110111111011001111101110110111011
20121121122b012222121200211110111111111100111101111a1111010111011001111001111011111a1110101111111111111111011101111110111a10111111011111111111110001111101111111
01210010211a002022221221021111100100110110111101111a1111111010011101111100111101101a1111110111100111111111011110110110010a11010011011110110101011111111111000111
21222011222b221212102012211111111111011011011111011a1110110111111111001100000111111a1101001011111111110111111111110110111a11111111100110111011111110111111000111
02202221221a221022100112211111111111111101111111110a1001111011111111110111111001111a1111101101011111111110111111111111011a11011011000111111111101101111111111111
12110211010a110012111110221111111101111111110111111a1111111111111111100110111111101a1111011101111111111011011111011011100a10111101101011111001010111111111100111
22002020222a212220112212221010110111110111111111011a1111111111111111111111111011100a1000011111111011011111111111111111111a01101111111101010111111111010111111011
22211021011b022221112111221111101111111111100011111a0111110111111111110100111111111a1011101011111111001111101011111010110a11100011111111110111111101111110111111
21121011211b212110211001111111101110111111101111111a0101100110111101110101101111110a1111011111111111111111011111101111011a11111111011111111110111111011111111101
12222210001b122111222212011111011011111110110111111a1110111111111111111010111110111a1111101111111111011111111110001111011a10101101110110111110001111111110111001
10122122210a121111122010210111111111111101111111111a1110110011011111111101111111110a1111111111101111111100101000011111111a11111111010001111110111111100111111101
10012102221a201111121220211010111101101101011111011a1111101101101111111101111111010a1111101100111111111010111101111111110a11111111110101111111101000111001101100
12212012112a112112101000111110111011111111110111111a1101111111111110111011011011011a0111101111111111111111100110111110011a11111111101110111110111101101111011101
12221002201b001121022101101101111111111111001111111a1111110111111100111111101111101a1011101011110111110011111111111111111a11111111111111001011111111111011110011
21001122221a021011101122121001111111111111111111110a0011001011111111111111111111111a1011011111101111110101011111111111011a00111101111111100111111111101111011011
20211111221b111220122221221111100111111101100101111a1011011111111111011111011111011a1111111101111011011111111011011111111a11111001011111111100111111101011110100
12200222101a111211202011211111110111110101011110111a0110111110011112122111102101120b0110201211020101111110110011111111111a10010111111111101111101111111101111111
12222121022a111001200112221111111111101110101111111a1101111101111020210202120121101a1012220102111011001111001111001111011a11101110111001101111111100011111111111
10111111101a1111010101010111111aaaaaaaaaaaaaaaaaaaaa1111100111111110110000122210212b1112011012221100111111011111101011110a11100110111100110111110111111111111111
11111011110a0111101111101111110a111011111111110111111101011111011111122222111101212b0222211221221110110111101111110011101a10011111110111111010111010111111101101
11111111011a1110110111111001111a111101111011111011111111011011100112221001211221122a1111122202000011110101110111111111011a11111111101111111111101111111011111111
11101011111a1111101111111111110a110111110111110111101101111111001020112111201202121b0220210212221110111110111111011100110a10111111110111001111111101111001101110
11111010011a1111110111011101111a101011110111001110011010101111111112121212111111010a1012121122011111101101110111111110011a11110111111010111111011111111111111111
11011111111a1110010111011111101a111101111111111101111100101101111112222102200022112b1202102112211110100111010110111111010a01111010111111111111001011111110111011
11111111111a1111111111110101111a101111111111010011111111001101011111120121111120122b1212121112121111111111111011101110011a11111111111111111011111111011011011111
11111111111a0001011111111110111a101111111011001001101110010111111102002222112111001a2211221201021011111111101101111011111a11111111101111111101011101101011100100
11111111111a0111011110111110101a101011001111001011111111111001111121012221021022101b1011222112100001111111001111001111111a11111110110011110011110101110111111111
10101111111a1011111111011011011a111011011111011100010101110111110121120120202022201a1222022112121111111011110110101110011a10111011100011111110101111111011011111
01111110111a1011111001111111111a111111111111111111111101111111011102111120111121111a1220011201101111111111011111110111111a01110100110101111110111110101101010110
11111011011a1110111111111110111a110111111111011111111111011111001111210221122211121b2212222202121111010101111111111111111a11011010101111110111111111111101011001
11110011101a1111111101111111101a001101111111111111100110111111110102111022122011222b1202002022221201100222211111001111011a10101111111111111101111111111011011111
01111101110a1110111000101101110a011111111111111101111110111111111122111112012010102b2222220222200221000221211201101101110a11101111011111011110111101011101111111
10111011101a1111101111101111011a111111111111110111101111111011110121112110222221111b2122220120222122012101202212110101111a11111011111111111111111011011111110111
11111110111a1101101011011111111a111111110101011111110111110011111112102112111102122b2222221000010110201221010101011111111a00011111111111111111011111111101111111
11111111111a1111110101111111111a111110102211112011002222121121122102122112222021201b0222210022010101012122122210111111111a11111010111111111111111011111111010011
10110111111a1111111111101010111a111111111210112111221100222221210022211220112110201b1211221222221122111101121222101111101a11101011001111111011111011111111110111
10111111011a0111011110111101011a111110021111012111100112212110210212112221210221012b2220021222200112120101112221101111111a11101111101111111111111111110111111111
11111111110a1111011111111111011a111111201212212112121202121012202022211111021221202a2222202111221202101011210022011111110a11111111111110011011111111101110111111
11110101101a1111111110111011111a111111111221221211221211211121220202211111222120112b0201202122110212222122022120101111110a10011111101011111001111111011110111110
11010101101a1111111111111011111a111101111112220212220110112021212222111210122222112a2112212202012201022212222221111111101a11111011111011111101001110011110001110
11011011101a1011101111111111111a011111110101110021012122101010011201202101112211111b0211222211112221121101122202101111101a10111111111110110100110111010111001110
11111111111a1011111110111101111a101110112220122212222120212100112210201111222211022b1212222220121021212110122110111111111a11111101111110011110110110101101101011
11101111011a1111111111111111111a111011201112112212221121212222121120022221220022212a1001221222202212220222111121101011111a11101111110101111110101111111011111111
11111111111a1110111111111101111a101100101122110102221101111112111110201221122200020b2122222222221022211111112212101110111a10111111111111111101111111101111010111
11111111101a1110110011010111111a111111201112122200022221102200110201120222212222222a0222022222201122121001121020101101011a10101110111101111011111111001011111111
11111001111a0111110101111111111a111101110112222011022022202120112122212211211111212a0212010221220122211211111111111111011a11111111111111101111011101110101100111
11111111011a1111111111000010111a111001010211121220211112222121221021101101111010112b2212210221101011111102011112100101110a11111110111101111111111111111111111011
11001111111a1111111111101011100a001111021212111210122100101112221201111111111111112a1122221021121110210110121221011111111a11110111100011011111111111111111110111
11101111101a1110011111111110101a110100022220122211112212211212100102111111111100111a0020211020221220102121121111111110111a01110111101111110011101101111110111101
11110100111a1111111101110101111a111111212112121211121022012121022122111101111111112b2111011220120121202202110002101111011a00111111111111111111101111111011101111
11111110101a1111111011110011111a110111121222122220102120210120221122001110111111110a1211121020022202111010101220111111111a10011111111011111100111011111111011111
11111111011a1111111010111111111a111111112110121220210220201120101220110101111110112a0111102211201112211200222122111111010a11110111001111111111111101111111111111
11111101111a1110110111011111010a110111210211102120222121122121121122100111110010111b1222100111110122221022010201001111111a11101110010011101111111111100111111110
11111111101a1101101110110110101a101010020002122221222221222022202011022100101111111a0110222011201212100001021102111101110a01111110111011111111111110111111101110
11111111111a1111010111111110011a111101122100222210121122122002122202021100111111001a1110111212111111212110122100110111111a11101110111111111111111111111110101110
10111111110a1110111111111111111a111101221222220022202120122212011022102000110011111a2022011210200111211121020211110010101a11101110011110011101110010101011111011
11101111011a1101011001111011111a111101122202121222022222001122022202120100111111112b2211220210020222220212112121111111111a11111111011111100111101101111101101110
11111000111a1101101011111101111a111111002022010112222022222220022221112111111111112a1101120200211110222021121210101111110a11111111111011111110111111111111111111
11111111111a1011001111111011001a011111110222222221122222121102111102210111111101112a2022020212010212112212122202111111110a00110111111110111111111111111111011011
11111111000a0111011011110101011a110101102102012210222222102222201202212110111100112a0221120101011101012021212100111101100a11101111111111111101100111111111110111
01011000101a1111111111110011111a111111220122221121212022120022210120102011111111111a1110111001111111111011110111111111111a00111101111111111101111110111011011110
11111111100a1111111111010111111a001110222221022122211222201021222221222111111100110a0101111110110111110111111101101010110a01111111110101111011111011010101111111
11011110111a1111111011111111110a110011111222220211112222222222022202222010111101111a1100011110011111110111111110111101111a11110100111111111111111111110101111101
11111000111a1101111111111011011a111111012220110202221222221202000020102111101111111a0111111100111111000010110101111111111a00111001110111111111111101111111000111
11000111111a1111111111111011101a101111101112221210122221201112111022220111111111000a1110111100111111101101110111101111011a11111111111111101011000101111111011011
11101101110a1111111111111011101a011011100222111201212112222202022112020011111001111a1101111111101101111111111111111011100a11111111111110110111111011101110011100
11101111111a1101100111110111110a111110011121111202212211212101121112212101111101111a1001101111111110111111110111101111101a11101111111110110111111111011110111101
10101101011a1111011111111111111a011001111212221012101221211111220212222111101011100a1111111100001110111111011011110111001a11111011101101111111011111111111111111
10111111111a1110111101000111001a111110011102220222110202122012120221212111111110101a1111011101101101111111111111101111111a01110111111101111101011110111111011111
10111110111a1111111111111110110a111111111122221211121112101221211221112111100111111a1111111111110111111110111101101111111a11111111111011111111111111101111110011
11010111111a1111110100111111111a201212020000120222212011222020010012021011111111011a1101111101111111111101111000101111000a11100111101111001111110111111111010011
11111100111a1111111111101111012b211022212201221222201222221111011102122110111001111a1111011111011101011111010010110111110a11111111110110111111001011110101111111
11001111110a1111111101111100112a202221001021212222102020020012122112201111111111101a1111110111110111111111011101111101111a01111111111011111111111111111111111110
01111111101a1110110110101111112a221021221202112222202001222110012200121111111011011a0111101111011110111111110110110111110a11111111110111111111111111111011011111
11111111111a1010111011111101110b222211221000122102202222222010021112101011101101011a1111110111011111110111111111111101111a11110010111111111111111111111111111111
00111101111a1001101111110111101a212122221120222212222201010220122122022011111111000a0101111111110110111111101001111110111a11011111110101111111001111111111111011
11010110111a1111111111011111002a110020111211101222022122122102112202212110111111101a1111011111111011100011111111100110111a01111011111110111101111111011111111110
11111110111a1111110101111111111b221212120202021020221022222221212021202110111111111a1111101111110111111101101001101100110a11111111111110111111110011111111111111
11111011110a1101111001011100101b2111012102202221220222212002111bbbbbbbaaaaaaaaaaaaaa01110111111111101aaaaaaaaaaaaaaaaaaaaa11110100011111101111101111111001100111
11111011111a1111111111111111112b2121222121122221111212220222121a1122022011101111111001111101011111100a1111111101001101101111111110011111111011000111101010111101
10110111010a1111111111111111111b0022100222220222222122122222222b2222111101111111011111000011011011110a1111011101111111111110111111111111111111101110111111101111
11111111111a1011000111111111112b1022222111022222212122222211022a2101212111111111111111100101111101011a0010010111011110100111010111110101101111111110111011111111
11111011111a1111011111111111111a2102201222122110221220210212201a2121001011011000110111101110110111111a0101111111111111111011111101110111011111001111111111111000
11111111011a2120212101112220202b1022222102120120212120121020011a1111101111001011100011111111111011110a1111111111101111100110011101111111011101001011111111110111
11111111111a1202111220100110212b1211221111121221222201212111111a1010101111111110111111101111111011110a1111100110100111111110100011111111110111010101111011101111
11111111111a1220111001212221102b0220221212211022111102100122111a0111111011011111111100101111111011111a1111101011110011110101111111111111110111110110111110111111
11111111111a2111020210221202221b2002212222112121112002222120111a1111111111011111111110110110101111111a1101111111110011111101110111111011111110011111111001110110
10111111111a0221111212112221102b2221010022222011111121112011100a1111101111111111111111110100101111111a1101111111110111110011011011111111011011111001111110101111
11111110111a1020201022002121020b0202122122110012211201022211111a1111111011110100111111111111111111111a1101101111111011100111101111100011111011111111111101111011
11110111111a0211111121210001220a1212212222012011112221221222110a1111111111111110110111111011111111111a1101110010100010011110111111011111111100101010111111011111
11110101111a1221121120210112222b2222012222221222101011110010101a1111110111010111011100111101101111111a1111011011101111111111111111111010111111111111111110111111
10111101111a0212101212200202220b2202222121122221222202021211101a1111111111111010101101110011001111111a1111010101111111111101111010111111111011111101100210120112
00011111111a1211102000200020110b2022222122121120000212111101111a1111011111111011111111101111111111111a0010101111110111011110111111111111111110110021201021212121
11111111111a2120120211021120211a2221111222200121002222111202111a1011110111111111111011100111111111100a1001111010100111111111111110111011111111201121121101221112
11111111101a1222002222221221122b2102122122020202221022210021111a0111111011111111111110111111111111111a1111001111101111110110111111111101110101022121011121110202
11111111111a1220210212222222210b2122221221022120222012202220101a1101111111111101101111101111111011111a1101111111111111111111111010110011011111112222200102122222
01101111111a2112221122201022122b2222202212222122222221220002100a1111111111111100111111111111111111111a1111011101001110011110111111111110111111101000112110011011
01111111011a2222100120012022111a2102210212022212112202221112111a1111111110101011101001111101111011110a1100111111111111111111010101111110011101201120201222221111
11111111101a2122121010102201221b2211200212101212010121112111111a01111111000111001aaaaaaaaaaaaaaaaaaaaa1111111101111001111111111111111101111101201112020211111202
11011111101a2202122212210222022a1201222122212222212001111221011a01111011101111001a110111101111111111111101111111111111111111111011111100000111201222201122212221
11110011110a0212112121012212100a1001212210111111100111111101101a10111011001011100a110111110111111111010111111111111111111011111111110111010111202111222021212221
11010111011a2221120121210211110b2011221120111111111111110101110a11111111100110011a101111111101111110111110111111101111101011011111111111101011120112112222211221
01011111111a1110110102222111000a2112101212011111111111000111111a11111011111101111a101111111111011101010110111101010011100111111011111111111000121011121102111102
01111111101a2212101210002210220b1221110222111111111111111011101a11101110111110110a110000011111111110111111111111110101111011101111101110111011101021212021022220
11001101111a2122211221201212221b2121211222101011101011111111011a11111111111111011a111111011111111101111111111110011010101100111111111111111011122112210121222120
11111011111a1222121121202102121b1202210201101111110111101011111a11111101101111111a111000111011011111111110011100111101110110110000011111101111000022122112002011
11111101111a2111201211112112122b0120011010110111111111111100001a11111111111111101a011101101111111111011010111100001111111111101111110110011110101112121112222220
11111101111a1210012121111012202a2110111201010111111011100111100a01111101011101101a111110110111101111111011101110111011111111111111011111101111020220220211211121
10111011111a0221112122222211111b2111011022111111110111101111111a00111110111111111a111111110111101110111111111111111111111011111110111101101111222101212212112120
11111100111a1120022222210102012b1212022221011111111111101111111a01111001011101111a111011011110101011101111110101111111111110111110010110011111122111202002200121
11011111011a1112222211212202202b0200222122111110110111111001011a11110111111111011a111111111011111011111111111111111111110111101111110101111111021201220111012221
11111011111a2222221022202220112b1022111112111011111111001101111a11110010001111101a111111111011111111111110101111011111101111111111110111011011211222211210121122
11111101111a1011222120112221212a2121122220111111101011100100100a10111110001110111a011110111111010100001111011111000111011011100110110111111111220221200212002011
10011100110a1111111011101011110a0111111101011111110111110001111a10111100111110101a100111111011111111010111111111110111111111111111100111101111122011222022111111
11111110111a1111011001110111011a1011111110100011111111111110011a10111111011010110a101111111011111111111111111111111011111011111110010111111011021110122122121222
11111101001a1011111111111101110a1001110111111111111111111111101a11111111111100111a011100100111111111111110110111111111110111111101111111111101010212011222201211
11111111011a1110110111100111100a1111011111111011111111011111110a01101110111111111a111011110111101111011111110101111111111111001111011111111101221122122112011122
11111111101a1011110111011111011a1011110011011101111011001111111a10011111100111101a111111111011001111111111111111110101110111011111111010111111202011212222122212
