(2,156)
(112,158)
(30,25)
(14,68)
(5,68)
(113,82)
(70,41)
(103,153)
(109,56)
(105,104)
101110111111101101111011111111111111100111111101111112200222211202002002021121020121010110010011111a1110111111111010110101111011111111110011a1111101011001111100
100101111101111111111100111111111111111011111111111112020212122212100112021202222220101101001010111a1010111010111111111111111111111111111111a1110100111111011101
111110111111111111111100011111111110101111110111110112212222022222120202222212202221110111001111101a1110011111111110111110111011000100011101a1110011111101101010
111101111101111111111111111110111101111011111111111012222021221020020022221212220211111011011011101a1110011111101111101111111110111111001110a1111111111111111111
111011111001101111111011011011111110101100111111110012021212122202012112021120220021111101110101111a1011111111111101101111101111111101101110a1110111111111111101
111110111111111010010110111101101111101111111101111112221221222222221022022220112221111000011111111a1111011011011111111111011101100100001011a0111111101111111111
111111111111111110111100011110011111011111111111111112121202200220010222202222212221110001111111101a1111111111111101100100100101101111111111a1111111111110011101
111101111110111111111101111010101011111111101111010112222222202202022122202111110201011111111111111a1110100110110101101111001011111111111011a1110111111111011111
111111111101111111111110111111111101111011111111111110211122222202120222112211222221111111111111101a1101111111111110100110111011100111110110a0100101111111111101
011011111011111111111011111101111111111010111101111112220221200012121220100111221221111111011111111a1111111101011111100111010110000011010111a1111111111101110101
111111101111100111111101110010111111101111111111110112122222001222201202222202222211011111110111010a1111101101110111111111111111111111011111a1111101111101111111
111111111110111111111011110111111011111111101111111112222212120210222212201222212221101111010111110a1111111111111111010111111111111111111011a0011101111101111101
111111111011101111100001101111101111111011111111111012212222220210220012211022122221110111001111100a0111110110110111101111011110101110111111a1110111101110010011
110111111110011111111111111101111010111011111101111011021202222212010221111012222021111111101101111a1011000111001111111011010111110011111010a1101111111101111110
101111011111111111111101110110011101110111110011111112122222222200222112222101201221111000111110101a1011011111101110101111111111100111011111a1110111111111011110
110011111122111220121212011200220220211111101011101110120002000122220122222122222221111011111111111a1111100101011110111101111011011111110111a1111101111111111101
111101100121222212202210011121000222222211111111001111221100222212222222220222202221111111111111111a0111101101110110011111111010111111111111a1110011111111111011
010101111112001201101202120120211022121211110011110101212222210102210221210202202021111111111011101a1110101011011101111010111011111011111111a1101111110111101111
111110000110022122120112110212121012211111111110100112012210222002222212102222222101111011110111111a1011111111111111111001101111011111111011a1101111110011111110
111111111110112122221100001211112120021111110101111012212202220212212222221220222200111010111101110a1110011111001110111111111111101011111111a1111001110110111111
111111111111210211212221121221222120112010111111011011101011222201111121212210122010111101101111011a10111111111111111111aaaaaaaaaaaaaaaaaaaaa1111111101101110111
111111111110211022212212011121211112220211101001101111011121101121011121222222212220011011110111111a00101111010011011111a011011110101111111111111000110011111101
001111101110111012102211111112120121122011111111110111112220222200111120221221122121111111111011111a10111110111110110010a111111111110101011111011111101101111111
010110110110210002220021101112022111112011111111111112121111202212220212210022112011111111110100111a11101111111111111111a111110111101111111111111101011111111110
011111111102111111210211122112002201121211111111110100112102102122121112021202111221111111011101011a11111111111111111111a111111111101101101010111111111101111101
011101100111212221201202021101122101121211101111011112221212210022122011021112112221111101110111011a11111011111011111111a111111111101101110110111111111111111111
111111111010222012102201012112211212102011110010111110121021022112201222121101211111110011111111010a11111111101111011110a111111111011111111111111110111110110110
111111110012102121121011201021222211022201001101111111110212112010102220211021102121111111010111111a11100111110111001101a111110111111111100111111111110100111101
001011111110221212202210111110000212121211110111001112111200212211201222112102022101111111110111111a01110101101111111111a011011111111110111011111110111011111110
111111111111110221102101122211122221222010011111011101111111111101111111110111011111111011110111101a11011101011111101111a111111111111111011011101110111111111111
111101001120212210120121022211021110101210111111110111011111110111110111011111111111111111011011111a11101111101111110011a111010111111111011001011101111101111111
111111111112121102012221112212110122021111000111111111111111111111110111100111011111111101111111111a01111111111111001011a011111100101111111111011011101111101111
011111101112211210121220210021210122212011011111001101111111010111111111101010111111111111111111111a10001011111101111111a111111111110110011111110111111001111111
aaaaaaaaaaabbbbbaabbbaabbbbbbabaaaabbaabaaaaaaaaaaaaaaaaaaaaaaaaaaaaaaaaaaaaaaaaaaaaaaaaaaaaaaaaaaaa01110111111111111111a110111110111111111111111010111011111110
110110111121002011100211220002111221122211101011111111110011110101011110110111101111110111100111011111100111111111111011a111111101111010011110111111111111110011
111111110112021210021222012021122111122111011101001111110111111111111111011111111111110011101111111111111111111011111111a111011110111111011111001111111111110011
111111111021021102121212221101111211221111111111111111101111111111011011110011011110101111111111111101101111110111111001a111111111111111111010111111111011111111
111011011121122111101101112011000001222200000101000111101011111111111011011010011101011111111111101111111111110111011111a111011111111111111011101011010111111111
111111110012101021122222201211201001221211111111100111111111111111111111011111001111101010101101111111101111101011111110a111110111111111011011101001111110111011
111011111111222210121121110212021112220101111111101111001111111101111101110111110101101000111011001111111101100111101111a011011111101111111100110111111100100111
101100111110120211102121111222212100220211110011111111100011111111110111111011101110011110110111111111111001101101111011aaaaaaaaaaaaaaaaaaaaaaaaaaaaaaaaaaaaaaaa
aaaaaaaaaabbaabbaaba21001221220122101011001101010101111100011111111011111101111aaaaaaaaaaaaaaaaaaaaaaaaaaaaaaaaaaaaaaaaa11111110111111011111aaaaaaaaaaaaaaaaaaaa
1110111111111221210a01012121221110122110101111111111110111111111111011111101101a111101111111111011011111110111111111111a11111111111100111110a1110111111110111110
1111100111211112122b21211120201221102011111010011111110111110010101011111010101a110111111111111101111101111111111111101a11111101111111111011a0101111111110010101
1101110101222222122b21122211120110102120001011111111111111111011100110111101011a111111011011011111111011101111110111011a11111010011110111111a0011111011111110110
0111101111110111110a11101111110111111111011110011011011111111111111111011110110a111111110101111111110111111101111111111a11011111011111101011a1011111111010111000
1111101101111110010a11111101111011111111011111111111011111101111110111010111110a101011110111011001111011111111111111110a10111111111111011101a1111001110111111011
1011010111111111111a11111111111111111110111111111011111101011111101111101111111a111110111111111111111011111111101011111a11111101111111111111a1111101111111111101
1111011011011101111a11111100111110001001111111111101101111111101110111011111111a011101110111101111110111110111111111101a11111011110001111011a0011110111111110111
1111111111101101111a11111111111111111000110110110011111011111110101101111111111a111110110111001011111111111111111011011a11011110011111111111a0010111111100111111
1111111111011111111a01011011011101110010101011110111011011011101101011111110011a111111101111111100111111101111110110101a11011110110011110011a1111110111111111111
1111101111111110111a11011111101011111111011111100111111111111001111111111111110a011111111110110101111101111101111101011a11111111111111110111a1010111111111111011
1111011111111111111a10101101011001111111011101101110111111110101101011111111110a111011111011011111111111110110110111011a01010111011111101110a1111111011111011101
1111111101111111111a11111111010100101111111111111101011111111111001111111111110a111111111111111111111111010111011111111a11101101101111101110a1101111111111111111
1101011100111101111a01110110111111111101110011111101110110011111111111111110011a111001101111011101011011111111111010111a11011111111011111111a0011110011101111111
1001111101111111111a11101011211222122210221212221020120110111110101111111111111a111110111111111111011011000101111111111a01110101000110101111a1111101011110111101
1111000111101111110a11111022220121122211122022111010022211101101011111111111111a111001100111101111111111101111111101111a01111111111101111110a0011101111010101111
0110001111101101111a11011101211121210120122201212120202201111111110101111101111a111101111011011111111111111011110111011a01101111111101111111a1111111110111111111
1101111111111101001a01111110202110111210012212120020212001110100111011111111111a111111111111101111011111110111111111111a10111111111101111100a0010111100111111111
0111111111111111100a11011012201222122200122020211121022111100010110111111111111a111011111111011111111111010111011011110a01111101111111111110a0011111011100011111
1011111111111111110a11011112020212222110210002201120110011111111111111111101111a110001000101111110110101011111101111111a11101110001111111111a1111011110111111011
1011101111111111110aaaaaaabbbbbaaaaabbbbbabbabaabbbbaaabaaaaaaaaaaaaaaaaaaaaaaaa100011111111111111111111110111111111111a10101111111011111100a1111101011111110011
11111111111111110110111001201121211222102001101112200112111011111011101011111111101111111011101111011111111110111101111a11011111101101111110a1111111111011111101
11110011101111101101101011011020101121102212211211101210011011111010101011101111111111110101110111011001011111101111111a11111111111111111011a1001111111111101111
11111110010111110101101111001212111211221121221101122101111111110111110111101111110001111011101101011111111111011111111a11111110101101111100a1111001111111111100
11011011111111111111111000221102022210122200120211201212010111010111100011101110011111001111011111110011111011101011111a11101111001111111111a1111110111111011101
11011110011011110111100111022112221212221110202122110210111101111111010011111111111111101110011101111111011001111111111a11111101110001101110a1100111011011111110
11101111111001011101111111001110122101222211112011212202001001111101111111111110110010001010101111111111110110111011101a01111111100100110011a0111010111011111010
11110010111111111011111111011221101221112212221222122222110111111101110101111011101111111111111111111111011110111111110a00111111111011111111a1110110111111110111
01111111111111111001110111212100112102111110121121112121011111111110111111011011111111110111111001111011111111111111001a11111101110110111101a0111011111011101111
11111111110111110111111110111202121220202101101202020101111011101111101011111111111011011111111101111111110111101111001a01111111011101111111a1111111111111101111
10011111111111100101101111110222101201122212112000121212011011110110111011011011011110111111011111111101101011110110111a11111111111111111111a1011101011011111111
10111111010101111111110011101112212110212020222222121110111011101111111111101101101111110111110111111011111111111111111a11111110111011111111a1110111101111111111
11111111010011111111101111220122002112211122101112121101111111111011111101011101111111111101101111100011111110011111111a11110011101101110111a1111101111111011101
01111011111011101011011111221001212000102122011211111210110111111101111001111100111111011111111111011001011101111001111a11111111111111011111a0110101101111110111
11011111111111110111001110122201221210210122112111222110111110111111011110111110011011111101111111110011110111111111101a11111101011111111111a0111111111111111111
11110111111111011111011000222221112101222200222111110011101111111111111111101111111101110111111110111001111111110101011a11110010111111111111a1111111111101011101
10111111111101101111111111211211211012200121011220220010111110011111011101011110111111111111100101111111111011111101101a11111101010111111111a1111101010101111111
11100111000111011111011101211100210221120221020222021021100011110110011101111110011111110101011111111111111101101111010a11010111111111111110a1111111111110011111
11111000111011111110111110022222212222112212121202122111100111011110101010111011111111111111101100111111111101111110110a11111001011110101110a1111111101100100111
11101111111100111111111111221211121211011121222112202221011111110111110111011111111100111110111111111111111111001111010a00001111110011111111a1100011111111011101
11111111111111111111111011221112221110220020201012212220111111110110110111111111111111010111111011101111101101100111011a11110101111111011111a1011101111101111011
11111111111101111111001110222121002121210211012010112221011111011110111010110100110110111111110011001111111110011111111a11110110111110111111a1011111010111111001
01111111111001101111111111221201212111121121112012020211111111011111100111111110111011111111111111110111101111111111110a11111111111011011111a0011111111001101001
11111100111111111100111111121222222022122021021122201010111110111111110111011101100111111111111111111011010111110111101a11111011100100101101a1110111101110011001
11101111011101111111111110111111111111111111110011101111111111111111111111011111111110111110111111011011111111111011111a11110110011111110111a1101111110110011111
10111111111111111111111111101011101111111111100111111111111011111010111111110101011011101110111110011111110101111111110a01100010110111111111a1011110111111111101
11111111111111111101111101111011111111110111111111101011111111011111110110111111011011111001101100001111010111111111110a11111111111110011111a1011110111111111101
11111011101100111000111011011111111111101011101111111111111111110011111111111101110111111111111111111111110111111011111a01111111111111100022b1012122211102002022
10111111101011111111111111101101011101111111111110101100101111111111101111011100011101111111111101111111111111111111011a01111111111101110110b2202010121220222210
11101111011011011001111111101100111101101110110111111111011111111011111111111100111110011101211121011012211112110212020a01111011011011101112b1101020201021112002
11111111001011011100111111111111111011111011111111010111101111100000011110101100110111110121110212220121021112110120102a10110111011111010011a1201001222222122222
11111111111111111010110110110111111111110111011110111111101111111111101111011111111111111121102212212212212211221211221a11111111000110111121a2002220121002121111
11011011111111111111110011111110111111110110111111101111111011111101111111111101111011111022211111211011221211212122021a11011111111110011011b1121212222111120220
01111010111111111110011111111110110111101121222112121012201101120220012000111111101011110112102112121220121121211221021a11111101101010111000b1221112122022202211
11011110111111101011101101111111111111111221112121122011012022221221122111111011111110111111211221022212222210012012210a11101011011111111122a0210222112121122111
10101011111110100111100001111111001001110121102101201121211020012121210101110111101111110201012011012110211121012021012a11110101011110111121b2111210122112021201
11001111011100001101001110111111111111111122212011211211220211122122202001111111100110111222222021020221220111021110122a11111110111110111110a2122221111121201111
01111101001111011110000111111111111111111221202121221221221210222221220212210202022201221212220202002110012102211121220a11111111111111101121a0221222110201211111
11111111100110111101111111101111111111101112221100112212120210111212202212022220110221212220210222110002110201011012112a11111111110111111001b1122122222110211211
11101011111011011110111111011111111101011201201002110202212220010222221122021102201210112222212220021200222121022212021a11111111111110101012b0121212012122021121
11100101111111000101111001111011111101101122122210020211212001110220002011121122021221111121101221022220212221100012110aaaaaaaaaaaaaaaaaaabba1210021210202222121
11111111110011111001111111110001111011111200222022122222010022212202021211122022111110112210202221010200212121201112211aa111111111001111111121021020111121210202
11111111111110011010110011110111101111010112222222112222120201221202012021222120011021121021022122002211222220112122120aa111111101111011110100012000102102110110
11010111111110110111111001111111110111111121122202211011212102120200012002122212222121112220222221012101120221111212122aa111101111010111112202222012220211101212
11011111111111110111010111111111011111111220221222101211011222220222222220212220000111202022002122100112111022210221122aa110111010010110112211010022211112220221
11101111111110011111011111111011010110011122020122221221011221102212002012022222101220011011222021221122121121120212010aa011111011101011110220222200010221002222
01111111111111101111111111110010011111111212100201101111112220121202112212121011101111112212222211222212122221121022211aa111111011111111102010122121212120121122
11111111111111111011111000111111111111001122222220111002102201012221222210001121221202221222222121121112022202022201121aa011111101111111001222012122210222122201
01111111110101111011111110011111101101111002112102111022020111211020222011201112112200110211111122120110121221212122121aa011011101111110102022212021100212021212
11111110101110110111011011101111101111110212221120100120110221002111200112012201112221120222012101112121122211101112122aa111011010110111112201112021112120102110
01111111111111111111111111011111111111111122111011120110202220222112110121102121120222222102212201212001122202221211121aa111111110111110111112211212222022012011
11111110111111110101111101111111111111110111222111220212222222111120220122100211221212102112122210021010212100222102122aa110111111110111110222021211122101222012
11111000111011100100111111111110111110111022211221221121111222011010222101212120010112210220102202122220211221111122120aa111110111011111012111111120222222221211
10001011111111111101010111011111111110111121221101201201121121111002120012011212002121101222212121020022001020021112102aa111111111101011012112112220011021111112
10111011111110111111010101111111011111110021212122122122112112122202222222001120112121100102222121122221100120010112202aa001011111111101111222021221121210112021
10101110101110111111111011111100111111111121121121212122212210220112220022121201222222101202202220212202020121121100222aa101111111111111111212111220010221112212
10110111101011111110111111111011111111111221001202221121221222102201212220202220120122122200200221202211012211111101211aa101101100111011111001101201102212221011
11011111110001111110011111110101101111110120112222221220211222111012222122221201000112122101112222012022201201201020122aa011101111110111001011111111010111111011
00010111110111110111101111111001111011111120120112202220222200112022202102221111222111211222222220001021220222021121121aa111111101111001111010111111111101111110
