(105,19)
(22,157)
(47,150)
(54,136)
(30,7)
(44,22)
(22,12)
(30,75)
(8,148)
(118,59)
1110111110010011111111011111111111011011101111110110111111101a111111100011111a01000110101111111111110110111111100111111011111101111111112212111ba1010121aa200210
0110110010011110111111101111110110110111111111111011111110111a110111111111111a11111011110111111110111101111111011111111011101011111110220222122b22212111a1102100
1111110111111110111000011101101111111111001110011111111011111a111111111001011a10111110110110111011011101111111111111101110111011111101201010201b22221120a1210220
1011111101110111011111111111110111110101111111111101100010111a111111110111101a10101111110111101111011111110101110111111111101111111112112112021a11122111a0020202
1011111101100111111111111111101101111110101101110111111111010a111101001010111a11111101111111100011111011011111111101111011111110111110101112000a00011112b0112002
1111110111110111111001011110111111111111111111011101110111111a111110010100101a01101111101111111111011111111011101111001011111100111102112012121b11222220b0111111
1111011111111100111111111100011111111011111111111111111111011a111111111011111a11001101111110111111111111011111110101011111111101111012112121220b21022211b2111010
0222120111122220222121220021111100111111111111111110011110111a010111100110111a11111101111010111111011110111010110001011110011111011111211210222b10002220a1222211
1120222212211212112121121121110010111111111011111110111111110a011111111001111a11111101111101101111110110110111101011110001100111111011122122122b22122222a2120121
2212222100102122111111021021101101111011111111011111011111111a111111111110110a10110111111101011101111011011111111111111011011111111102112221221a00021011b0210102
0220211011112021211122022221111111111101101101111111110111011a011111110111110a10101111110111111111011111111111111011111011100111011110121111112a20201122a2102121
1212012221211212102201221211011101111111111001000110111011110a011111111111101a11111111011111111111011010111110111111001010010011011112212110212a11212222a2212222
1112212211101201022101210201111101111111111111111110111111101a101111111010110a10001100110111000101111111111111111110111111111111111111012211102b20220121b2021220
2210121101122222211211110201111100010111111001110011101111110a111110111111111a11101110011110111011110110011110011111101101111111111010201212212a12220111a1111220
2212121002221220212112021220001111111111111111111111011111111a011010011001110a11110101111111111100111111111111001111111101010111010112211120021b12100012b0021211
2201210022212021201220221211111111111011101111111111111011001a120210211210101b02112211110111111111110111111111111011111110111001111110112022201a02110121a2222211
0021221021010121122222111201111111110111110111101111111111112a020210020102201b21002211101211101110111110110111111111111111111111110111221112022b21111011a1202021
0102222211201222220000222111010101110111111111111101111111112b221122221111122a20201121101211010100111111111011101101111110110111111011102111222b11020121b1021022
2122222022120202221202010100111011110111111111111011011101111a212101211111012a12112102021211011011111111111111101110011101101111010111011111220b10112121a0221212
0120212210222221202022121211110100110111111110100001111111111b002021121111111b12211221112201111111100011111011111111111111111111111110021212210b01110211a2201110
2220221002100012202212122100111111111111111111110111110001112b112221222111120a22212222021201110111111111101011101111011111101111111111112211021a01121120a2112222
1020202212021122202002220020101111111011101011111111111011110b120102011221200b21222222212111100111110110011111111111111111111110110111112211211a01222101a0012210
0220221222220020222112121221111110111100100011010111010111112b022210210221100b11021021011110111011111001111111111110101111111110111111220020202a22222211b2221201
0222012221200200201120121111101011110111111111111111111111111a011202210002022b22101102002011111111010110011111111011110011111111111101101011111a01101111a1101111
2221020221022220222122200221111111011100111100110101101100012b222022121211212b22122201211111111101101110101111011010111111111101111101111111110a11111111a1011111
1221120202112222122220001111111110111111010110101111110111110b220222112121002b22111012022011111011111001111110010111011111111110111111100011111a11101111a1101101
0001221221220222222222112020111111110100010101110101011111111b102121022012012b01102000202211011111101111111111101011111111111111001111111111011a11111110a1111111
2222220010221022212222112221111110101110111111111111011111112b222221221121112a21222022212211111111111011101111101001111111111011110111111011111a11011111a0011111
2200222220202122222222222211111110111110111111101011110101010a221220111012222a22021002111211101101111011111111110111111001111111110101111011110a11111101a1110101
2212210221022222220220222222101211011011111110111111111110101b121122210020201b21012211102110001100111111111111111011111111101110110111110110101a11011111a1111111
1222022122222220221122022012112220211011111011110111011101111a222011120111221b12122222212201011111011111101011101111111101111110111111111111110a11110010a1110101
2020202202221222221122202212211121112011111111111001101111102b221220111212112a11110211221111111101111101111111110011110111011011101111101111111a10011111a1111111
2122022022122221021222222211211222120000101111111110111111112b012021122221212b22220121211110111011111111111100101100111101111111101111111222222b01202021b1222212
2011201220022222222002222222211102221001111111111011111111112a211012202122112b11212201011111111111111111101111011111110101111111111111112222000b01121021a2101221
2111221022222022220220222011121112122111101111101000010111112a001102112122121b12012222012011111111110111111111110111111110101110111011120210211b12122212b2012122
2120202221222220010222122011221020120001011111111111110011011b220112210020102b12122011201211110010101011111001011010111101111110111010100112200a21122022a1110211
1212021202222221222212111221110121020011111110110110111111112a120122102222011b11112111221111011110111111111111101111111011001101010101122112122a22122010b1112102
2022120022222112221110111121212011122111111110110011111111112b221122201021101b02022111020200111011111111110111111110111010101111111111122011200b20022012b1202222
2201222221122222222220222212111011011111111011011110101110110a212222121011122b02222221012111011111111111111111111111111111110111111111112012122b01012100b1100122
0122111222200222221022101002221012111011011011111111110101011b202220111022212a22201211121211011101011111110001011111001111010211112212222010222a01212021a1211202
1212201221021222212212022212022212021111111111111111111011102a102221011110211a22221121122011100111111111010110111111011112111222020022202222212b21120200b0211212
1121202022022222022222222102201012101111111011010110101111101a122111020112210b22021112112101111010010101111111111110111110121222221000110022020a22002121b2211022
2222112210212211022022112222222002122011111100001111111111111b122102122121212a22202221202210110101111101110011101111100111012221021221202102212b21212221a0002021
2220111202121202222222211120122111122110101011110011111100012a210220102222001b21220222121211111110100110111111111111110110210112120200222222212b20222212a1121212
2212100222222002220222102111122121222111011110110111110110102a112212101220011b02122021200000111111011111110111101111110111221221021211102221212a12222022a2121100
1111110222211221102000020010210121211011011110111100111101110a111101111100111a11011011001110111011111011111011111111110012211221002022020221202a22212022a1101101
1111101121112110211020021122222122210111110110110001111110101a110110111111111a00010110011011111001111101111101111111011101201122201212221122021b22202202b0212122
0111011221121222222220122211002112222111111011111111011100111a111111111101111a11101111111011110011111111101111101111011111020212001110221201200b22222201b1021222
1111111111122221111122211220011020222110110111111111011111111a111111111111111a00111110111111111111111111111111111000111110211011001201222202222b12221011a2022212
1110101012102121011122022210212112120111111100011111101111010a111011111101101a11011110101100011111111011110011111111100111111222210212022210222b22202021b1200110
1101001121212010102120211211211101210111111011111111110011111a011101101011111a11111111111111010111001111111101011111010012122211022211222222022b22222222b2121221
1111110120220101121121121111210202211110111010111111011101111a110011110111101a01111111101111011111111011111011111111100111110210122102212022102b22221201a2210112
1111011221020112202222121200221210112111111111111111111101111a111111111000110a01011111111111101111111111111111011011111112120120121120222022012a22212221a2201221
1111111121101120010121110001022201200001011111111101111111111a111101111111101a11111111111111110111101111011011110111111110121112011201200222222a02212122b2201200
1111011212100112221201122110212222112101100111001111111111111a110111111101111a00111111101111101110011101101101111111011101102112121110222222221b12221221b0021001
0101101112221211020022121101101121110011111111110111001011110a110111111011111a11110111101010110111110011011111111111101112202212222021202012221b22020222b1001000
1011111111211012222021221021120011212111111110011111101100001a111111111010111a01111111001111111011111001111011111111111102111112212002110222222b21220202a2121111
1110110220012212211122211111101110222111110011111011111111111a101111111010111a11101100111101011111101101111011101100101111112011211022100222122b21120221a1122022
1100111211121211100111222111101102101111111011101111010100111a111111110101011a01111110111110011111111111110100101111011102201221200022220222200b22222222a2112121
1aaaaaaaaaaaaaaaaaaaaaaaaaaaaaaaaaaaaaaaaaaaaaaaaaaaaaaaaaaaaa111110111111111a01011111110111111111111110011110111111111112121022010102220222222b01122111b2122002
0a011111110111001111011011111010111111110111111111111111111100111011111011011a11110101111111100000101111111111111111101111101102121022022221222b02121221b0121110
1a111011111111110101111111111101111111111101101010111011111110111001111011111a11100110111011111111111011110111111110001112022102110201021221222b20012221b2121221
1a111111111111110101111111111110111001111011101001111111001111111111111100001a11110111100111111101111111111111111101011000122201010112112112010a11212111a0111110
1a011110111111011011111101111111110111101010000111110101111111111111111111100a11111111111111111111100011111011110011100110110021222110212221101b11001011a1011010
1a111111111110101110111110100110111111101001111111111101101111111111101101111a11111011111111111110111110111111110111111112110101122221221210021a22011011a1101101
1a111111111110111111111101101100111100110111111001111101011011001111111101010a11110111001111101111110101111111110110111002212101121222112221012b22121111a1111111
1a011111101111111111011111111111101101011001111010110101111111110001111101011a10110111111111011111111111101111101010011102120212121122021122212a22212001a1111011
1a101111101111111011110110011110111111111111111111101110111111111101111111011a11111001101110111110111011111110010110101111211012122222222212121a11221120a1110011
0a111111111011110100111101111110101101010110001111101010001111111111111111101a11101111111111011111111111110101111001111112110211212111102111200b00211121a0111011
1a111111110111111111110111111111111100101111111111101011111111111111111011111a11111011101001110101011100110111011111101111101101111011111110110a11110110a1111001
1a111110101011011111110101111111111001011110001111111111111110101111101001111a11111001111111101111111110111101101101111111111110101111110100111a11111011a1111111
1a101101111111100011110111101111011101111011111011111111011111011110111101101a11011011101001111111001011111111111011011110111101101111110111111a01101011a1111100
1a111100111111110001111110111010111110111011011011011001110110111111111111111a11111111111110101111111111111111111011111011111111111111011101111a11011111a1010110
1a111111111111011111101111011101111101111100011111111010111111001101111111101a10111100110111010111110101111101111111111011111011111111101111101a11111111a1011110
1a111111111111110111111100111111111011011101111111111111110110111011111101111a11111111111110111101111110111101111110101011111101111111001101110a11110111a0111110
0a011101111111111111101111111111011111111101111111111011111101111111111111111a11011011101110111111111100010111111111111110111111111110101011101a01111110a1111111
1a011111111110111111011001010111011101111011111110111111111111010111111111111a11111011011011111100111101111110111011111111111111111010111101111a11011011a1100111
1a111010111110111111011111111111011110111101011010101101111111110011010111011a11110010101111110111110101111111110100111101111100111111111111100a11100111a0111100
0a111111101111101110111101011111011111111011101111110111110011011111011110101a11111111101101101011111111111111110011111101100101010001111101111a11111111a1111110
0a101110101111111110011011111111101011101111111011101111011110011111100111110a11111111011011100111111011011111111011111111111111111110111111011a10100011a1111101
1a101001111110111101111111101100111111111111011011101111101100010101101111111a11111010011110111110011111110101111101111110111110111111111111110a11110011a1110101
1a111111111111011111111111111111011110111011110110111011111011101001111111110a11110111101011111111111011010101111111111111111010111101110111111a01110111a1011111
1a111111111111110101111111110111111111010110111110111011101110111110111110111a01011110011110101111111011111101110011110001101111111101101111111a11111101a1111101
1a111101111111011111101101011011111011111011111111010011011111100111101111011a11111011111101111000111110001111111111111111111111111110101101111a01110011a1111111
0a111011011111110111111011111111111001111001011010110111111111101111111111001a01111111101111111011111111111111111111110111111111011011001111111a11001111a1111111
1a110101111111111111111111111111111110011101111111110111111101111111111011111a11101101111101010011111111110111111111110001111111011101011111100a01101111a1101011
1a010111110001111110110111101111111111110111111101110111101111111111111011111a11111111111111110111011111101010111101010101111111111111011111101a11110111a1111111
0a100110111111011101111101001110111111111111111011111111111111110111101111111a11101001110111111111111111101111011011001111111111110101000111111a11101100a1111111
1a111111111111110111111111101101111101111111111011111111110011111111110011100a00110111111111111101011111101111100101010101111010111110011110111a11110111a1010111
0a111011110111011111111111100111101011101110011101101111110110010111011111110a01011111111111100111100111111111110111101110011111111111111111111a00011111a1111111
0a010111101101011111110111111011111101111111111111111110111011111111011101011a10110111111111010101111111111111011111111001011011110011110101101a11110111a1111111
1a011110111101100111111111110100010011111111110111101111111111011111110111111a11010111010110111100111111101101100101011111011111111011011111110a11101011a1111111
0a111001011111111111111011111111110011010111111111111111011101111101111101011a11111111111111111111111110111101111111011111111111101111111111101a11111111a1110111
1a110011111111111011111111111111010011011111111111011111101111111111101111111a11011111111101111101101001011111111111111110110011101111111111111a11011110a1011011
0a111101011011101111111111100111111110111101111111011111111111111111011111011a01101110111110011111111011111111101111111111111110111011111111111a11111111a1011111
1a111101110111111111100011101111001101110011111100000110011111111111101011111a11110101111111101111111110111111011111100101101111110111111111111a01101111a1111110
1a011101101111101111011111111001111111101011111111111100100100111111111111111a10011111111111111111111011111111111011111111101101000111101111111a01110101a1011111
1a111110110111111001010111110111111111111110111111101110101001111110001111101a11011111111111111111111111010111111111011111111110110001111111101a11111001a1111101
1a101111101111001101111111111101111011111110100110010110101111111101110101111a00110111111111110011110011010110101111111111110111101111111111111a11111110a1100110
aa111111101101111111111010111110101101100101111111111111111110111111011110111a11111111111111100111111111011111111111111111110110111001111110101a11101111a1101011
11011111111110111111111111011111110101111101111111111010111001011111110111000a11111111111111111111110111101011101110111111000111111111111101111a11111111a1111110
11111010111111101101111111111111101101111111110101111111010111111110111111011a01110110100110111110100101111111111111111111111110111111011111111a01111111a1110110
11101111111100010111110111111011111001110111110111111111011011010111101110111a01100101011111111111100111111111011001111111101111111111111110111a11111111a1111111
11111111011111111111111111101111010111111111102220211221101102122111212211101a11111111111111111111100110101111110101111011110111010110111111111a11011111a0111110
01011111111001011110111111111110111111110101111220102110010222010202210211111a01111111111111111110011111101111111111111111011011111110111111111a11111111a1111111
00111110111011110101011111111111111101100111110211102111222212121211212111111a11111111111111101011111101101101101111111011111111100110100110111a11111011a1101000
01101110011101101111111111011111111111111100112021120122120212200112002111111a11011011111111111111111111111011111111111111111101111101111000110a11011110a1110011
11111111111100111111111111011100111001111111122212222201212111102101110021111a11111111111101101111111111111110110111111111111111111110011111101a11111111a1110111
10111111111111101111111111110111111111111111122112221020002222200111020122011a11111110110111110111011111110111111011101110100011111101111110111a10110010a1111110
11111111111101111011101111111101111111101111211122211200211102120221022110110a11111111100101111111111111011011101110101011111111111111111111111a11011111a1111011
11111101111111110101111111111101110111111011201122112111221221122212112120100a11111110011100101011011111001101110011101101111111111110111111111a11011101a1111111
11111011111110110111111111011011110011110110020112110202112222112021101122010a10110101011111111111011111111011111110111111011111011110001110111a01101101a1011111
11110111111111110011100111001111011111111111120010222010212211212111122212110a11111110111101111011111111110111010111111111111111011111011111001a11010111a0011001
11011101111111111111111101111110011111101111221022221120202112222022221121111a11111011111010111111111111111111111111011110110101101111110111111a11111111a1110111
01100011111111111110100110111111011111110111011102012111000012000222122112111a01010111111111111101110111110000101111101111110111100111111111011a11111101a1100111
11001111110111111100111011111110111010110111220021211022121012222212212221111a11111101111111011011111110011101110111111111010011110111111011111a11010011a1011111
11111111011110111111101011111111011111011111211111021222202221211212112201111a11110111011110111111011111101111101011110110111111111111111011011a11111111a1111111
11111111011111101111101101101111010011111111102202120220222202101222211211111a11111111101111111011100101101110111111110101101110111101111011101a11111011a1111111
11111111111111111111011001011111001111111111120122212021211120220110222121111a10111110011100111111111111101011001110011111111011111111111111111a10101111a1111011
11101101110011010110111100111101111101001111211221121212112202022211201221111a11111011011011111101101111111111111111111111111111111011101111010a11111111a0110111
